期号,front1,front2,front3,front4,front5,back1,back2,日期,front_sum,front_span,front_odd_count,front_Zone1_count,front_Zone2_count,front_Zone3_count,front_consecutive_count,front_repeat_count,back_sum,back_span,back_odd_count,back_is_large
7001,22,24,29,31,35,4,11,2007-05-30,141,13,3,0,2,3,0,0,15,7,1,1
7002,15,22,31,34,35,5,12,2007-06-02,137,20,3,0,2,3,1,3,17,7,1,1
7003,3,4,18,23,32,1,6,2007-06-04,80,29,2,2,2,1,1,0,7,5,1,0
7004,6,10,16,17,25,2,4,2007-06-06,74,19,2,2,2,1,1,0,6,2,0,0
7005,1,9,19,20,30,2,11,2007-06-09,79,29,3,2,2,1,1,0,13,9,1,1
7006,1,16,20,23,28,3,6,2007-06-11,88,27,2,1,3,1,0,2,9,3,1,0
7007,14,16,25,26,35,4,9,2007-06-13,116,21,2,0,2,3,1,1,13,5,1,1
7008,2,8,11,21,23,4,7,2007-06-16,65,21,3,3,2,0,0,0,11,3,1,1
7009,1,3,9,19,34,9,12,2007-06-18,66,33,4,3,1,1,0,0,21,3,1,1
7010,6,8,18,29,34,9,11,2007-06-20,95,28,1,2,1,2,0,1,20,2,2,1
7011,29,32,33,34,35,9,10,2007-06-23,163,6,3,0,0,5,3,2,19,1,1,1
7012,3,12,15,29,34,7,11,2007-06-25,93,31,3,2,1,2,0,2,18,4,2,1
7013,12,17,27,29,34,6,9,2007-06-27,119,22,3,1,1,3,0,3,15,3,1,1
7014,1,2,7,29,32,6,7,2007-06-30,71,31,3,3,0,2,1,1,13,1,1,1
7015,2,8,12,13,17,11,12,2007-07-02,52,15,2,3,2,0,1,1,23,1,1,1
7016,1,14,19,24,31,3,12,2007-07-04,89,30,3,1,3,1,0,0,15,9,1,1
7017,13,14,29,32,34,3,12,2007-07-07,122,21,2,0,2,3,1,1,15,9,1,1
7018,3,4,16,23,28,6,9,2007-07-09,74,25,2,2,2,1,1,0,15,3,1,1
7019,3,6,17,22,23,4,6,2007-07-11,71,20,3,2,3,0,1,2,10,2,0,0
7020,2,6,11,12,18,5,12,2007-07-14,49,16,1,4,1,0,1,1,17,7,1,1
7021,2,4,24,29,33,1,2,2007-07-16,92,31,2,2,1,2,0,1,3,1,1,0
7022,8,10,12,23,25,3,10,2007-07-18,78,17,2,3,1,1,0,0,13,7,1,1
7023,8,10,23,32,34,8,10,2007-07-21,107,26,1,2,1,2,0,3,18,2,0,1
7024,6,16,20,25,31,4,9,2007-07-23,98,25,2,1,2,2,0,0,13,5,1,1
7025,22,24,26,27,34,2,10,2007-07-25,133,12,1,0,2,3,1,0,12,8,0,1
7026,5,9,13,33,35,1,8,2007-07-28,95,30,5,2,1,2,0,0,9,7,1,1
7027,2,3,10,19,27,6,10,2007-07-30,61,25,3,3,1,1,1,0,16,4,0,1
7028,20,26,30,34,35,3,10,2007-08-01,145,15,1,0,1,4,1,0,13,7,1,1
7029,15,22,25,29,35,9,11,2007-08-04,126,20,4,0,2,3,0,1,20,2,2,1
7030,11,14,27,33,35,2,7,2007-08-06,120,24,4,1,1,3,0,1,9,5,1,1
7031,3,21,27,31,32,6,8,2007-08-08,114,29,4,1,1,3,1,1,14,2,0,1
7032,1,13,21,23,32,4,11,2007-08-11,90,31,4,1,3,1,0,2,15,7,1,1
7033,1,5,8,14,22,3,12,2007-08-13,50,21,2,3,2,0,0,1,15,9,1,1
7034,6,8,11,13,22,2,11,2007-08-15,60,16,2,3,2,0,0,2,13,9,1,1
7035,7,11,16,31,32,1,12,2007-08-18,97,25,3,2,1,2,1,1,13,11,1,1
7036,15,18,21,27,34,1,2,2007-08-20,115,19,3,0,3,2,0,0,3,1,1,0
7037,1,6,7,17,31,11,12,2007-08-22,62,30,4,3,1,1,1,0,23,1,1,1
7038,6,21,25,27,32,8,9,2007-08-25,111,26,3,1,1,3,0,1,17,1,1,1
7039,10,11,20,21,35,7,11,2007-08-27,97,25,3,2,2,1,2,1,18,4,2,1
7040,5,21,25,28,35,1,4,2007-08-29,114,30,4,1,1,3,0,2,5,3,1,0
7041,3,16,17,22,35,1,8,2007-09-01,93,32,3,1,3,1,1,1,9,7,1,1
7042,7,10,22,31,35,5,6,2007-09-03,105,28,3,2,1,2,0,2,11,1,1,0
7043,4,9,22,24,31,2,6,2007-09-05,90,27,2,2,2,1,0,2,8,4,0,0
7044,4,5,7,12,26,1,10,2007-09-08,54,22,2,4,0,1,1,1,11,9,1,1
7045,9,16,20,26,35,11,12,2007-09-10,106,26,2,1,2,2,0,1,23,1,1,1
7046,4,16,18,23,30,1,10,2007-09-12,91,26,1,1,3,1,0,1,11,9,1,1
7047,1,6,15,19,35,2,9,2007-09-15,76,34,4,2,2,1,0,0,11,7,1,1
7048,8,25,26,29,35,6,8,2007-09-17,123,27,3,1,0,4,1,1,14,2,0,1
7049,9,10,15,17,32,4,6,2007-09-19,83,23,3,2,2,1,1,0,10,2,0,0
7050,13,21,22,30,35,1,11,2007-09-22,121,22,3,0,3,2,1,0,12,10,2,1
7051,3,7,24,28,35,8,11,2007-09-24,97,32,3,2,1,2,0,1,19,3,1,1
7052,1,14,29,32,33,5,10,2007-09-26,109,32,3,1,1,3,1,0,15,5,1,1
7053,11,16,19,21,25,1,10,2007-09-29,92,14,4,1,3,1,0,0,11,9,1,1
7054,4,10,19,29,34,3,6,2007-10-01,96,30,2,2,1,2,0,1,9,3,1,0
7055,10,16,24,31,33,7,10,2007-10-03,114,23,2,1,2,2,0,1,17,3,1,1
7056,4,11,17,20,21,5,9,2007-10-06,73,17,3,2,3,0,1,0,14,4,2,1
7057,14,16,30,32,35,6,7,2007-10-08,127,21,1,0,2,3,0,0,13,1,1,1
7058,8,21,25,28,33,2,6,2007-10-10,115,25,3,1,1,3,0,0,8,4,0,0
7059,4,15,23,31,33,3,9,2007-10-13,106,29,4,1,2,2,0,1,12,6,2,1
7060,12,13,29,30,31,4,7,2007-10-15,115,19,3,1,1,3,3,1,11,3,1,1
7061,2,10,19,28,29,2,9,2007-10-17,88,27,2,2,1,2,1,1,11,7,1,1
7062,1,4,10,14,29,11,12,2007-10-20,58,28,2,3,1,1,0,2,23,1,1,1
7063,10,31,33,34,35,7,12,2007-10-22,143,25,3,1,0,4,2,1,19,5,1,1
7064,2,16,32,33,35,5,10,2007-10-24,118,33,2,1,1,3,1,2,15,5,1,1
7065,19,20,24,29,31,9,10,2007-10-27,123,12,3,0,3,2,1,0,19,1,1,1
7066,4,7,8,19,24,7,12,2007-10-29,62,20,2,3,2,0,1,2,19,5,1,1
7067,11,18,25,30,31,4,9,2007-10-31,115,20,3,1,1,3,1,0,13,5,1,1
7068,4,9,13,14,33,6,10,2007-11-03,73,29,3,2,2,1,1,0,16,4,0,1
7069,2,13,16,21,35,1,5,2007-11-05,87,33,3,1,3,1,0,1,6,4,2,0
7070,7,26,29,30,35,3,4,2007-11-07,127,28,3,1,0,4,1,1,7,1,1,0
7071,10,22,32,33,35,1,7,2007-11-10,132,25,2,1,1,3,1,1,8,6,2,1
7072,21,24,26,27,33,1,5,2007-11-12,131,12,3,0,2,3,1,1,6,4,2,0
7073,4,5,9,12,23,2,11,2007-11-14,53,19,3,4,1,0,1,0,13,9,1,1
7074,16,17,23,24,31,5,10,2007-11-17,111,15,3,0,4,1,2,1,15,5,1,1
7075,5,11,20,30,32,7,11,2007-11-19,98,27,2,2,1,2,0,0,18,4,2,1
7076,2,9,12,15,31,9,10,2007-11-21,69,29,3,3,1,1,0,0,19,1,1,1
7077,4,6,12,13,24,1,4,2007-11-24,59,20,1,3,2,0,1,1,5,3,1,0
7078,9,12,14,22,23,1,2,2007-11-26,80,14,2,2,3,0,1,1,3,1,1,0
7079,6,9,25,26,31,2,8,2007-11-28,97,25,3,2,0,3,1,1,10,6,0,1
7080,1,15,20,25,27,5,10,2007-12-01,88,26,4,1,2,2,0,1,15,5,1,1
7081,6,18,20,22,35,4,9,2007-12-03,101,29,1,1,3,1,0,1,13,5,1,1
7082,3,5,14,33,34,7,8,2007-12-05,89,31,3,2,1,2,1,0,15,1,1,1
7083,1,5,20,21,24,3,4,2007-12-08,71,23,3,2,3,0,1,1,7,1,1,0
7084,5,11,18,29,34,10,11,2007-12-10,97,29,3,2,1,2,0,1,21,1,1,1
7085,17,24,28,29,33,2,5,2007-12-12,131,16,3,0,2,3,1,1,7,3,1,0
7086,14,18,19,26,28,3,9,2007-12-15,105,14,1,0,3,2,1,1,12,6,2,1
7087,8,18,30,31,33,4,9,2007-12-17,120,25,2,1,1,3,1,1,13,5,1,1
7088,17,18,21,23,33,6,10,2007-12-19,112,16,4,0,4,1,1,2,16,4,0,1
7089,8,13,24,30,34,1,12,2007-12-22,109,26,1,1,2,2,0,0,13,11,1,1
7090,4,20,24,31,33,9,12,2007-12-24,112,29,2,1,2,2,0,1,21,3,1,1
7091,7,12,26,31,32,3,8,2007-12-26,108,25,2,2,0,3,1,1,11,5,1,1
7092,6,19,27,28,29,6,10,2007-12-29,109,23,3,1,1,3,2,0,16,4,0,1
7093,6,8,16,25,27,8,12,2007-12-31,82,21,2,2,1,2,0,2,20,4,0,1
8001,1,2,11,34,35,3,10,2008-01-02,83,34,3,3,0,2,2,0,13,7,1,1
8002,1,12,24,31,32,10,12,2008-01-05,100,31,2,2,1,2,1,1,22,2,0,1
8003,1,11,13,32,35,2,7,2008-01-07,92,34,4,2,1,2,0,2,9,5,1,1
8004,9,22,24,31,33,8,9,2008-01-09,119,24,3,1,2,2,0,0,17,1,1,1
8005,18,25,29,31,34,9,10,2008-01-12,137,16,3,0,1,4,0,1,19,1,1,1
8006,10,12,26,29,34,5,7,2008-01-14,111,24,1,2,0,3,0,2,12,2,2,1
8007,3,4,5,12,28,3,12,2008-01-16,52,25,2,4,0,1,2,1,15,9,1,1
8008,2,6,8,17,32,8,9,2008-01-19,65,30,1,3,1,1,0,0,17,1,1,1
8009,4,8,12,24,30,5,8,2008-01-21,78,26,0,3,1,1,0,1,13,3,1,1
8010,6,23,24,27,29,6,8,2008-01-23,109,23,3,1,2,2,1,1,14,2,0,1
8011,14,20,22,24,27,7,10,2008-01-26,107,13,1,0,4,1,0,2,17,3,1,1
8012,2,10,29,32,35,2,3,2008-01-28,108,33,2,2,0,3,0,0,5,1,1,0
8013,1,11,19,22,35,5,9,2008-01-30,88,34,4,2,2,1,0,1,14,4,2,1
8014,4,7,10,28,34,1,6,2008-02-02,83,30,1,3,0,2,0,0,7,5,1,0
8015,9,18,20,27,33,6,9,2008-02-04,107,24,3,1,2,2,0,0,15,3,1,1
8016,8,10,11,17,19,6,9,2008-02-13,65,11,3,3,2,0,1,0,15,3,1,1
8017,2,14,25,29,32,1,6,2008-02-16,102,30,2,1,1,3,0,0,7,5,1,0
8018,3,6,7,11,30,2,3,2008-02-18,57,27,3,4,0,1,1,0,5,1,1,0
8019,8,24,25,29,31,4,5,2008-02-20,117,23,3,1,1,3,1,0,9,1,1,0
8020,4,5,15,17,33,4,8,2008-02-23,74,29,4,2,2,1,1,0,12,4,0,1
8021,5,10,13,21,24,4,9,2008-02-25,73,19,3,2,3,0,0,1,13,5,1,1
8022,9,12,13,25,31,8,10,2008-02-27,90,22,4,2,1,2,1,1,18,2,0,1
8023,6,26,31,32,34,7,10,2008-03-01,129,28,1,1,0,4,1,1,17,3,1,1
8024,8,12,17,20,30,1,2,2008-03-03,87,22,1,2,2,1,0,0,3,1,1,0
8025,6,10,12,15,28,4,12,2008-03-05,71,22,1,3,1,1,0,1,16,8,0,1
8026,1,21,22,24,25,8,10,2008-03-08,93,24,3,1,3,1,2,0,18,2,0,1
8027,5,17,23,31,32,4,8,2008-03-10,108,27,4,1,2,2,1,0,12,4,0,1
8028,3,11,17,19,26,7,12,2008-03-12,76,23,4,2,2,1,0,1,19,5,1,1
8029,6,11,18,29,30,4,11,2008-03-15,94,24,2,2,1,2,1,1,15,7,1,1
8030,3,21,23,26,35,5,8,2008-03-17,108,32,4,1,2,2,0,0,13,3,1,1
8031,14,20,23,27,28,2,4,2008-03-19,112,14,2,0,3,2,1,1,6,2,0,0
8032,3,9,19,27,33,9,10,2008-03-22,91,30,5,2,1,2,0,1,19,1,1,1
8033,3,10,21,23,30,1,9,2008-03-24,87,27,3,2,2,1,0,1,10,8,2,1
8034,6,7,18,34,35,5,10,2008-03-26,100,29,2,2,1,2,2,0,15,5,1,1
8035,2,12,13,29,30,5,7,2008-03-29,86,28,2,2,1,2,2,0,12,2,2,1
8036,9,19,22,30,32,1,10,2008-03-31,112,23,2,1,2,2,0,1,11,9,1,1
8037,11,20,24,31,35,4,10,2008-04-02,121,24,3,1,2,2,0,0,14,6,0,1
8038,12,13,19,32,33,2,10,2008-04-05,109,21,3,1,2,2,2,0,12,8,0,1
8039,7,11,15,27,35,4,7,2008-04-07,95,28,5,2,1,2,0,0,11,3,1,1
8040,4,8,19,22,29,8,11,2008-04-09,82,25,2,2,2,1,0,0,19,3,1,1
8041,7,17,21,22,28,5,10,2008-04-12,95,21,3,1,3,1,1,1,15,5,1,1
8042,5,10,13,32,35,4,5,2008-04-14,95,30,3,2,1,2,0,0,9,1,1,0
8043,5,8,10,31,33,2,4,2008-04-16,87,28,3,3,0,2,0,2,6,2,0,0
8044,2,21,23,27,32,10,11,2008-04-19,105,30,3,1,2,2,0,0,21,1,1,1
8045,14,32,33,34,35,2,4,2008-04-21,148,21,2,0,1,4,3,1,6,2,0,0
8046,11,25,26,27,35,7,8,2008-04-23,124,24,4,1,0,4,2,1,15,1,1,1
8047,12,18,22,23,30,6,12,2008-04-26,105,18,1,1,3,1,1,0,18,6,0,1
8048,1,13,22,25,27,2,10,2008-04-28,88,26,4,1,2,2,0,1,12,8,0,1
8049,1,11,14,28,30,3,10,2008-04-30,84,29,2,2,1,2,0,1,13,7,1,1
8050,1,5,11,26,27,3,7,2008-05-03,70,26,4,3,0,2,1,2,10,4,2,1
8051,1,7,9,11,33,3,11,2008-05-05,61,32,5,4,0,1,0,2,14,8,2,1
8052,3,18,19,30,35,5,9,2008-05-07,105,32,3,1,2,2,1,0,14,4,2,1
8053,1,13,21,23,32,3,6,2008-05-10,90,31,4,1,3,1,0,0,9,3,1,0
8054,5,14,23,31,35,2,6,2008-05-12,108,30,4,1,2,2,0,1,8,4,0,0
8055,2,14,28,30,35,4,12,2008-05-14,109,33,1,1,1,3,0,2,16,8,0,1
8056,15,19,25,30,31,3,9,2008-05-17,120,16,4,0,2,3,1,1,12,6,2,1
8057,5,8,9,17,33,5,6,2008-05-19,72,28,4,3,1,1,1,0,11,1,1,0
8058,3,9,11,29,33,3,12,2008-05-21,85,30,5,3,0,2,0,2,15,9,1,1
8059,7,13,21,25,31,8,10,2008-05-24,97,24,5,1,2,2,0,0,18,2,0,1
8060,3,13,17,23,30,1,11,2008-05-26,86,27,4,1,3,1,0,1,12,10,2,1
8061,7,10,14,19,32,3,6,2008-05-28,82,25,2,2,2,1,0,0,9,3,1,0
8062,1,15,27,28,29,3,10,2008-05-31,100,28,4,1,1,3,2,0,13,7,1,1
8063,7,11,24,30,35,6,8,2008-06-02,107,28,3,2,1,2,0,0,14,2,0,1
8064,14,18,24,27,31,6,7,2008-06-04,114,17,2,0,3,2,0,1,13,1,1,1
8065,19,22,23,25,32,6,12,2008-06-07,121,13,3,0,3,2,1,0,18,6,0,1
8066,2,7,21,22,25,4,12,2008-06-09,77,23,3,2,2,1,1,2,16,8,0,1
8067,3,10,14,15,22,4,7,2008-06-11,64,19,2,2,3,0,1,1,11,3,1,1
8068,6,9,11,33,34,6,10,2008-06-14,93,28,3,3,0,2,1,0,16,4,0,1
8069,5,13,16,29,33,6,8,2008-06-16,96,28,4,1,2,2,0,1,14,2,0,1
8070,9,17,18,21,31,1,5,2008-06-18,96,22,4,1,3,1,1,0,6,4,2,0
8071,1,5,11,14,25,1,9,2008-06-21,56,24,4,3,1,1,0,0,10,8,2,1
8072,10,25,32,33,34,3,9,2008-06-23,134,24,2,1,0,4,2,1,12,6,2,1
8073,2,5,6,7,31,8,10,2008-06-25,51,29,3,4,0,1,2,0,18,2,0,1
8074,10,13,22,31,35,4,12,2008-06-28,111,25,3,1,2,2,0,1,16,8,0,1
8075,1,10,13,30,33,6,7,2008-06-30,87,32,3,2,1,2,0,2,13,1,1,1
8076,3,5,10,27,34,1,12,2008-07-02,79,31,3,3,0,2,0,1,13,11,1,1
8077,1,8,21,33,34,5,7,2008-07-05,97,33,3,2,1,2,1,1,12,2,2,1
8078,8,17,20,28,31,7,11,2008-07-07,104,23,2,1,2,2,0,1,18,4,2,1
8079,20,23,26,32,33,5,12,2008-07-09,134,13,2,0,2,3,1,1,17,7,1,1
8080,6,9,29,31,33,5,11,2008-07-12,108,27,4,2,0,3,0,1,16,6,2,1
8081,7,8,20,22,29,4,7,2008-07-14,86,22,2,2,2,1,1,1,11,3,1,1
8082,15,19,29,33,35,1,2,2008-07-16,131,20,5,0,2,3,0,1,3,1,1,0
8083,6,14,15,30,31,3,10,2008-07-19,96,25,2,1,2,2,2,1,13,7,1,1
8084,2,17,20,22,25,5,11,2008-07-21,86,23,2,1,3,1,0,0,16,6,2,1
8085,3,7,13,15,19,2,10,2008-07-23,57,16,5,2,3,0,0,0,12,8,0,1
8086,1,6,10,22,35,3,7,2008-07-26,74,34,2,3,1,1,0,0,10,4,2,1
8087,14,22,32,33,35,1,5,2008-07-28,136,21,2,0,2,3,1,2,6,4,2,0
8088,7,11,19,27,31,2,3,2008-07-30,95,24,5,2,1,2,0,0,5,1,1,0
8089,8,13,24,32,33,3,9,2008-08-02,110,25,2,1,2,2,1,0,12,6,2,1
8090,4,11,18,33,34,2,6,2008-08-04,100,30,2,2,1,2,1,1,8,4,0,0
8091,9,13,19,22,25,4,10,2008-08-06,88,16,4,1,3,1,0,0,14,6,0,1
8092,3,23,26,32,34,4,9,2008-08-09,118,31,2,1,1,3,0,0,13,5,1,1
8093,6,7,10,24,30,5,8,2008-08-11,77,24,1,3,1,1,1,0,13,3,1,1
8094,7,12,19,27,34,11,12,2008-08-13,99,27,3,2,1,2,0,1,23,1,1,1
8095,3,4,11,21,25,1,7,2008-08-16,64,22,4,3,1,1,1,0,8,6,2,1
8096,6,7,12,25,28,2,12,2008-08-18,78,22,2,3,0,2,1,1,14,10,0,1
8097,1,10,31,33,35,3,10,2008-08-20,110,34,4,2,0,3,0,0,13,7,1,1
8098,7,10,22,27,33,4,8,2008-08-23,99,26,3,2,1,2,0,2,12,4,0,1
8099,3,18,23,25,30,6,10,2008-08-25,99,27,3,1,2,2,0,0,16,4,0,1
8100,12,20,26,29,30,2,6,2008-08-27,117,18,1,1,1,3,1,1,8,4,0,0
8101,10,13,23,31,33,4,11,2008-08-30,110,23,4,1,2,2,0,0,15,7,1,1
8102,5,25,26,29,35,3,10,2008-09-01,120,30,4,1,0,4,1,0,13,7,1,1
8103,2,11,22,30,34,4,9,2008-09-03,99,32,1,2,1,2,0,0,13,5,1,1
8104,7,8,10,24,34,8,11,2008-09-06,83,27,1,3,1,1,1,1,19,3,1,1
8105,12,21,22,26,35,4,5,2008-09-08,116,23,2,1,2,2,1,0,9,1,1,0
8106,3,5,21,28,33,2,6,2008-09-10,90,30,4,2,1,2,0,1,8,4,0,0
8107,1,2,13,15,16,4,9,2008-09-13,47,15,3,2,3,0,2,0,13,5,1,1
8108,11,16,24,29,32,9,11,2008-09-15,112,21,2,1,2,2,0,1,20,2,2,1
8109,1,10,18,28,34,5,8,2008-09-17,91,33,1,2,1,2,0,0,13,3,1,1
8110,5,16,25,27,33,4,9,2008-09-20,106,28,4,1,1,3,0,0,13,5,1,1
8111,2,11,12,14,19,5,9,2008-09-22,58,17,2,3,2,0,1,0,14,4,2,1
8112,4,18,26,32,33,5,8,2008-09-24,113,29,1,1,1,3,1,0,13,3,1,1
8113,11,14,17,19,22,1,8,2008-09-27,83,11,3,1,4,0,0,0,9,7,1,1
8114,2,3,22,27,31,6,7,2008-09-29,85,29,3,2,1,2,1,1,13,1,1,1
8115,7,9,19,21,33,7,10,2008-10-01,89,26,5,2,2,1,0,0,17,3,1,1
8116,6,8,15,24,31,1,3,2008-10-04,84,25,2,2,2,1,0,0,4,2,2,0
8117,13,23,24,25,30,2,8,2008-10-06,115,17,3,0,3,2,2,1,10,6,0,1
8118,6,9,19,25,30,6,12,2008-10-08,89,24,3,2,1,2,0,2,18,6,0,1
8119,1,2,10,19,27,1,11,2008-10-11,59,26,3,3,1,1,1,1,12,10,2,1
8120,21,23,24,25,32,3,4,2008-10-13,125,11,3,0,3,2,2,0,7,1,1,0
8121,11,23,24,32,35,4,10,2008-10-15,125,24,3,1,2,2,1,3,14,6,0,1
8122,3,6,12,20,29,9,12,2008-10-18,70,26,2,3,1,1,0,0,21,3,1,1
8123,1,6,12,28,31,8,9,2008-10-20,78,30,2,3,0,2,0,2,17,1,1,1
8124,2,10,13,29,33,6,10,2008-10-22,87,31,3,2,1,2,0,0,16,4,0,1
8125,1,4,28,33,34,6,11,2008-10-25,100,33,2,2,0,3,1,1,17,5,1,1
8126,9,29,32,34,35,1,8,2008-10-27,139,26,3,1,0,4,1,1,9,7,1,1
8127,8,21,22,31,33,1,7,2008-10-29,115,25,3,1,2,2,1,0,8,6,2,1
8128,12,15,23,24,25,10,11,2008-11-01,99,13,3,1,3,1,2,0,21,1,1,1
8129,13,16,20,25,27,4,5,2008-11-03,101,14,3,0,3,2,0,1,9,1,1,0
8130,3,5,22,29,34,7,12,2008-11-05,93,31,3,2,1,2,0,0,19,5,1,1
8131,8,9,12,21,32,7,11,2008-11-08,82,24,2,3,1,1,1,0,18,4,2,1
8132,6,14,24,27,29,5,9,2008-11-10,100,23,2,1,2,2,0,0,14,4,2,1
8133,10,12,15,33,35,3,9,2008-11-12,105,25,3,2,1,2,0,0,12,6,2,1
8134,11,13,15,28,35,8,10,2008-11-15,102,24,4,1,2,2,0,2,18,2,0,1
8135,7,22,25,29,33,1,12,2008-11-17,116,26,4,1,1,3,0,0,13,11,1,1
8136,3,28,29,32,34,1,6,2008-11-19,126,31,2,1,0,4,1,1,7,5,1,0
8137,1,10,25,32,35,5,9,2008-11-22,103,34,3,2,0,3,0,1,14,4,2,1
8138,4,5,18,22,35,7,8,2008-11-24,84,31,2,2,2,1,1,1,15,1,1,1
8139,1,6,10,14,22,6,8,2008-11-26,53,21,1,3,2,0,0,1,14,2,0,1
8140,2,9,11,29,32,8,9,2008-11-29,83,30,3,3,0,2,0,0,17,1,1,1
8141,9,15,18,30,34,4,5,2008-12-01,106,25,2,1,2,2,0,1,9,1,1,0
8142,6,18,21,30,35,8,9,2008-12-03,110,29,2,1,2,2,0,2,17,1,1,1
8143,1,2,22,29,32,1,4,2008-12-06,86,31,2,2,1,2,1,0,5,3,1,0
8144,10,19,27,28,33,5,12,2008-12-08,117,23,3,1,1,3,1,0,17,7,1,1
8145,5,16,27,29,30,5,11,2008-12-10,107,25,3,1,1,3,1,1,16,6,2,1
8146,9,23,24,26,33,7,12,2008-12-13,115,24,3,1,2,2,1,0,19,5,1,1
8147,16,18,19,24,35,11,12,2008-12-15,112,19,2,0,4,1,1,1,23,1,1,1
8148,3,7,20,33,35,4,7,2008-12-17,98,32,4,2,1,2,0,1,11,3,1,1
8149,2,5,6,27,29,3,4,2008-12-20,69,27,3,3,0,2,1,0,7,1,1,0
8150,1,9,10,15,25,3,8,2008-12-22,60,24,4,3,1,1,1,0,11,5,1,1
8151,7,10,27,31,34,8,9,2008-12-24,109,27,3,2,0,3,0,1,17,1,1,1
8152,3,5,14,20,33,7,11,2008-12-27,75,30,3,2,2,1,0,0,18,4,2,1
8153,2,4,6,25,26,2,5,2008-12-29,63,24,1,3,0,2,1,0,7,3,1,0
8154,5,7,10,29,32,4,6,2008-12-31,83,27,3,3,0,2,0,0,10,2,0,0
9001,1,15,23,27,30,4,10,2009-01-03,96,29,4,1,2,2,0,0,14,6,0,1
9002,1,4,7,12,30,5,10,2009-01-05,54,29,2,4,0,1,0,2,15,5,1,1
9003,16,18,23,30,32,2,11,2009-01-07,119,16,1,0,3,2,0,1,13,9,1,1
9004,1,3,22,32,35,6,10,2009-01-10,93,34,3,2,1,2,0,1,16,4,0,1
9005,10,11,15,31,32,5,8,2009-01-12,99,22,3,2,1,2,2,1,13,3,1,1
9006,2,4,22,31,35,9,12,2009-01-14,94,33,2,2,1,2,0,1,21,3,1,1
9007,6,14,15,29,35,6,11,2009-01-17,99,29,3,1,2,2,1,1,17,5,1,1
9008,4,17,21,29,31,2,12,2009-01-19,102,27,4,1,2,2,0,1,14,10,0,1
9009,12,18,23,26,32,6,9,2009-01-21,111,20,1,1,2,2,0,0,15,3,1,1
9010,2,9,12,21,29,7,11,2009-01-24,73,27,3,3,1,1,0,1,18,4,2,1
9011,2,11,13,14,21,2,4,2009-02-02,61,19,3,2,3,0,1,2,6,2,0,0
9012,2,5,20,25,31,10,12,2009-02-04,83,29,3,2,1,2,0,1,22,2,0,1
9013,5,24,26,30,35,5,12,2009-02-07,120,30,2,1,1,3,0,1,17,7,1,1
9014,8,14,15,25,26,7,9,2009-02-09,88,18,2,1,2,2,2,1,16,2,2,1
9015,1,5,10,16,27,3,4,2009-02-11,59,26,3,3,1,1,0,0,7,1,1,0
9016,10,11,20,26,27,9,11,2009-02-14,94,17,2,2,1,2,2,2,20,2,2,1
9017,5,11,23,26,33,4,12,2009-02-16,98,28,4,2,1,2,0,2,16,8,0,1
9018,1,6,13,28,29,3,9,2009-02-18,77,28,3,2,1,2,1,0,12,6,2,1
9019,4,29,31,32,35,4,10,2009-02-21,131,31,3,1,0,4,1,1,14,6,0,1
9020,5,16,18,32,35,2,11,2009-02-23,106,30,2,1,2,2,0,2,13,9,1,1
9021,1,15,31,32,34,3,8,2009-02-25,113,33,3,1,1,3,1,1,11,5,1,1
9022,12,14,17,34,35,4,11,2009-02-28,112,23,2,1,2,2,1,1,15,7,1,1
9023,15,17,21,27,33,7,11,2009-03-02,113,18,5,0,3,2,0,1,18,4,2,1
9024,29,31,32,33,35,10,11,2009-03-04,160,6,4,0,0,5,2,1,21,1,1,1
9025,3,17,22,23,33,4,10,2009-03-07,98,30,4,1,3,1,1,1,14,6,0,1
9026,24,30,31,32,34,10,12,2009-03-09,151,10,1,0,1,4,2,0,22,2,0,1
9027,3,22,26,33,34,9,10,2009-03-11,118,31,2,1,1,3,1,1,19,1,1,1
9028,6,20,30,32,35,9,11,2009-03-14,123,29,1,1,1,3,0,0,20,2,2,1
9029,3,4,13,17,24,4,11,2009-03-16,61,21,3,2,3,0,1,0,15,7,1,1
9030,1,7,27,30,32,1,4,2009-03-18,97,31,3,2,0,3,0,0,5,3,1,0
9031,7,11,19,21,22,1,11,2009-03-21,80,15,4,2,3,0,1,1,12,10,2,1
9032,4,12,20,26,29,6,10,2009-03-23,91,25,1,2,1,2,0,0,16,4,0,1
9033,2,8,18,21,32,8,11,2009-03-25,81,30,1,2,2,1,0,0,19,3,1,1
9034,5,19,31,32,35,4,9,2009-03-28,122,30,4,1,1,3,1,1,13,5,1,1
9035,3,7,9,28,33,3,8,2009-03-30,80,30,4,3,0,2,0,0,11,5,1,1
9036,2,12,26,31,33,9,10,2009-04-01,104,31,2,2,0,3,0,1,19,1,1,1
9037,17,18,19,25,31,1,11,2009-04-04,110,14,4,0,3,2,2,1,12,10,2,1
9038,6,17,20,29,32,4,5,2009-04-06,104,26,2,1,2,2,0,1,9,1,1,0
9039,1,3,7,10,33,3,4,2009-04-08,54,32,4,4,0,1,0,0,7,1,1,0
9040,3,16,30,32,33,1,10,2009-04-11,114,30,2,1,1,3,1,2,11,9,1,1
9041,5,9,20,23,29,4,10,2009-04-13,86,24,4,2,2,1,0,0,14,6,0,1
9042,11,24,25,26,31,2,7,2009-04-15,117,20,3,1,1,3,2,0,9,5,1,1
9043,5,21,22,32,35,2,5,2009-04-18,115,30,3,1,2,2,1,0,7,3,1,0
9044,1,7,18,29,34,3,9,2009-04-20,89,33,3,2,1,2,0,0,12,6,2,1
9045,1,9,14,24,35,6,9,2009-04-22,83,34,3,2,2,1,0,1,15,3,1,1
9046,1,9,24,34,35,4,9,2009-04-25,103,34,3,2,1,2,1,4,13,5,1,1
9047,13,18,21,24,29,3,6,2009-04-27,105,16,3,0,4,1,0,1,9,3,1,0
9048,5,6,22,25,27,11,12,2009-04-29,85,22,3,2,1,2,1,0,23,1,1,1
9049,5,16,28,29,34,11,12,2009-05-02,112,29,2,1,1,3,1,1,23,1,1,1
9050,5,15,28,32,33,8,9,2009-05-04,113,28,3,1,1,3,1,2,17,1,1,1
9051,3,11,22,26,29,5,12,2009-05-06,91,26,3,2,1,2,0,0,17,7,1,1
9052,23,24,30,34,35,1,3,2009-05-09,146,12,2,0,2,3,2,0,4,2,2,0
9053,5,9,24,31,33,5,6,2009-05-11,102,28,4,2,1,2,0,1,11,1,1,0
9054,2,12,19,29,30,7,12,2009-05-13,92,28,2,2,1,2,1,0,19,5,1,1
9055,5,8,14,23,24,5,6,2009-05-16,74,19,2,2,3,0,1,0,11,1,1,0
9056,4,13,17,32,35,3,6,2009-05-18,101,31,3,1,2,2,0,0,9,3,1,0
9057,6,15,22,27,30,2,9,2009-05-20,100,24,2,1,2,2,0,0,11,7,1,1
9058,8,10,14,27,32,2,7,2009-05-23,91,24,1,2,1,2,0,1,9,5,1,1
9059,2,13,14,29,33,4,11,2009-05-25,91,31,3,1,2,2,1,1,15,7,1,1
9060,18,28,29,30,31,4,8,2009-05-27,136,13,2,0,1,4,3,1,12,4,0,1
9061,2,10,21,26,34,2,10,2009-05-30,93,32,1,2,1,2,0,0,12,8,0,1
9062,4,22,23,29,31,5,11,2009-06-01,109,27,3,1,2,2,1,0,16,6,2,1
9063,5,6,18,21,22,1,7,2009-06-03,72,17,2,2,3,0,2,1,8,6,2,1
9064,6,10,11,17,34,11,12,2009-06-06,78,28,2,3,1,1,1,1,23,1,1,1
9065,1,12,24,27,32,2,11,2009-06-08,96,31,2,2,1,2,0,0,13,9,1,1
9066,1,8,19,24,31,6,12,2009-06-10,83,30,3,2,2,1,0,2,18,6,0,1
9067,3,6,25,28,32,2,5,2009-06-13,94,29,2,2,0,3,0,0,7,3,1,0
9068,2,12,15,20,28,1,12,2009-06-15,77,26,1,2,2,1,0,1,13,11,1,1
9069,14,16,27,30,33,8,12,2009-06-17,120,19,2,0,2,3,0,0,20,4,0,1
9070,10,21,24,30,31,3,10,2009-06-20,116,21,2,1,2,2,1,1,13,7,1,1
9071,4,20,29,30,33,2,11,2009-06-22,116,29,2,1,1,3,1,1,13,9,1,1
9072,23,26,29,32,33,5,10,2009-06-24,143,10,3,0,1,4,1,2,15,5,1,1
9073,1,10,19,21,30,1,4,2009-06-27,81,29,3,2,2,1,0,0,5,3,1,0
9074,15,17,19,23,32,1,11,2009-06-29,106,17,4,0,4,1,0,1,12,10,2,1
9075,1,7,11,32,33,9,11,2009-07-01,84,32,4,3,0,2,1,1,20,2,2,1
9076,3,9,11,18,24,4,5,2009-07-04,65,21,3,3,2,0,0,1,9,1,1,0
9077,7,20,28,32,34,6,8,2009-07-06,121,27,1,1,1,3,0,0,14,2,0,1
9078,11,23,26,31,34,5,11,2009-07-08,125,23,3,1,1,3,0,1,16,6,2,1
9079,1,2,7,13,34,4,10,2009-07-11,57,33,3,3,1,1,1,1,14,6,0,1
9080,7,16,19,29,35,2,11,2009-07-13,106,28,4,1,2,2,0,1,13,9,1,1
9081,2,15,20,25,33,3,6,2009-07-15,95,31,3,1,2,2,0,0,9,3,1,0
9082,5,11,26,29,32,8,11,2009-07-18,103,27,3,2,0,3,0,0,19,3,1,1
9083,2,5,28,34,35,1,7,2009-07-20,104,33,2,2,0,3,1,1,8,6,2,1
9084,5,9,19,26,35,2,10,2009-07-22,94,30,4,2,1,2,0,2,12,8,0,1
9085,6,13,27,33,34,9,12,2009-07-25,113,28,3,1,1,3,1,0,21,3,1,1
9086,1,2,7,26,29,10,12,2009-07-27,65,28,3,3,0,2,1,0,22,2,0,1
9087,10,24,28,30,33,1,10,2009-07-29,125,23,1,1,1,3,0,0,11,9,1,1
9088,13,16,27,32,34,3,9,2009-08-01,122,21,2,0,2,3,0,0,12,6,2,1
9089,3,6,11,19,27,2,7,2009-08-03,66,24,4,3,1,1,0,1,9,5,1,1
9090,18,25,30,33,34,4,10,2009-08-05,140,16,2,0,1,4,1,0,14,6,0,1
9091,1,5,17,32,34,3,7,2009-08-08,89,33,3,2,1,2,0,1,10,4,2,1
9092,10,21,22,27,29,8,12,2009-08-10,109,19,3,1,2,2,1,0,20,4,0,1
9093,7,9,22,30,33,9,11,2009-08-12,101,26,3,2,1,2,0,1,20,2,2,1
9094,1,5,21,23,29,5,12,2009-08-15,79,28,5,2,2,1,0,0,17,7,1,1
9095,8,18,24,30,33,1,6,2009-08-17,113,25,1,1,2,2,0,0,7,5,1,0
9096,7,12,28,32,33,1,3,2009-08-19,112,26,2,2,0,3,1,1,4,2,2,0
9097,6,13,14,22,25,1,4,2009-08-22,80,19,2,1,3,1,1,0,5,3,1,0
9098,11,17,19,25,26,2,10,2009-08-24,98,15,4,1,2,2,1,1,12,8,0,1
9099,3,9,21,23,33,6,10,2009-08-26,89,30,5,2,2,1,0,0,16,4,0,1
9100,16,20,25,29,33,1,8,2009-08-29,123,17,3,0,2,3,0,1,9,7,1,1
9101,2,10,14,22,26,4,9,2009-08-31,74,24,0,2,2,1,0,0,13,5,1,1
9102,11,13,29,32,35,10,12,2009-09-02,120,24,4,1,1,3,0,0,22,2,0,1
9103,16,20,28,32,33,1,2,2009-09-05,129,17,1,0,2,3,1,1,3,1,1,0
9104,15,25,29,32,33,10,11,2009-09-07,134,18,4,0,1,4,1,2,21,1,1,1
9105,1,25,26,34,35,6,11,2009-09-09,121,34,3,1,0,4,2,1,17,5,1,1
9106,11,21,22,25,34,6,9,2009-09-12,113,23,3,1,2,2,1,2,15,3,1,1
9107,11,12,33,34,35,1,10,2009-09-14,125,24,3,2,0,3,3,2,11,9,1,1
9108,1,9,14,29,30,7,10,2009-09-16,83,29,3,2,1,2,1,0,17,3,1,1
9109,2,11,13,26,35,6,10,2009-09-19,87,33,3,2,1,2,0,0,16,4,0,1
9110,22,28,30,31,34,7,9,2009-09-21,145,12,1,0,1,4,1,0,16,2,2,1
9111,4,11,13,19,35,10,12,2009-09-23,82,31,4,2,2,1,0,0,22,2,0,1
9112,2,8,12,34,35,4,5,2009-09-26,91,33,1,3,0,2,1,1,9,1,1,0
9113,3,4,10,18,27,6,8,2009-09-28,62,24,2,3,1,1,1,0,14,2,0,1
9114,2,8,25,29,33,3,7,2009-09-30,97,31,3,2,0,3,0,0,10,4,2,1
9115,1,2,6,8,26,5,12,2009-10-03,43,25,1,4,0,1,1,2,17,7,1,1
9116,12,15,23,30,33,9,12,2009-10-05,113,21,3,1,2,2,0,0,21,3,1,1
9117,7,21,29,31,33,9,10,2009-10-07,121,26,5,1,1,3,0,1,19,1,1,1
9118,10,17,18,21,34,5,11,2009-10-10,100,24,2,1,3,1,1,1,16,6,2,1
9119,3,12,22,23,28,4,12,2009-10-12,88,25,2,2,2,1,1,0,16,8,0,1
9120,11,23,27,28,32,2,5,2009-10-14,121,21,3,1,1,3,1,2,7,3,1,0
9121,4,5,8,11,22,2,10,2009-10-17,50,18,2,4,1,0,1,1,12,8,0,1
9122,1,2,11,31,33,5,6,2009-10-19,78,32,4,3,0,2,1,1,11,1,1,0
9123,10,21,28,29,32,6,10,2009-10-21,120,22,2,1,1,3,1,0,16,4,0,1
9124,1,3,14,32,35,7,11,2009-10-24,85,34,3,2,1,2,0,1,18,4,2,1
9125,8,20,23,29,31,2,11,2009-10-26,111,23,3,1,2,2,0,0,13,9,1,1
9126,14,23,27,28,33,8,12,2009-10-28,125,19,3,0,2,3,1,1,20,4,0,1
9127,5,9,27,32,34,5,8,2009-10-31,107,29,3,2,0,3,0,1,13,3,1,1
9128,6,21,28,32,34,4,7,2009-11-02,121,28,1,1,1,3,0,2,11,3,1,1
9129,2,10,18,32,33,3,8,2009-11-04,95,31,1,2,1,2,1,1,11,5,1,1
9130,9,14,25,32,34,2,8,2009-11-07,114,25,2,1,1,3,0,1,10,6,0,1
9131,2,3,8,33,34,3,11,2009-11-09,80,32,2,3,0,2,2,1,14,8,2,1
9132,2,10,12,15,28,4,7,2009-11-11,67,26,1,3,1,1,0,1,11,3,1,1
9133,1,8,24,27,34,10,11,2009-11-14,94,33,2,2,1,2,0,0,21,1,1,1
9134,2,16,19,28,33,7,11,2009-11-16,98,31,2,1,2,2,0,0,18,4,2,1
9135,6,8,15,20,32,5,6,2009-11-18,81,26,1,2,2,1,0,0,11,1,1,0
9136,7,13,23,24,29,6,10,2009-11-21,96,22,4,1,3,1,1,0,16,4,0,1
9137,12,28,29,30,34,1,9,2009-11-23,133,22,1,1,0,4,2,1,10,8,2,1
9138,3,4,14,28,32,9,10,2009-11-25,81,29,1,2,1,2,1,1,19,1,1,1
9139,14,16,20,22,32,5,9,2009-11-28,104,18,0,0,4,1,0,2,14,4,2,1
9140,7,8,19,26,30,1,12,2009-11-30,90,23,2,2,1,2,1,0,13,11,1,1
9141,13,14,21,30,33,2,8,2009-12-02,111,20,3,0,3,2,1,1,10,6,0,1
9142,5,6,13,24,31,3,11,2009-12-05,79,26,3,2,2,1,1,1,14,8,2,1
9143,1,9,10,11,22,1,12,2009-12-07,53,21,3,4,1,0,2,0,13,11,1,1
9144,18,26,32,33,34,4,6,2009-12-09,143,16,1,0,1,4,2,0,10,2,0,0
9145,5,11,14,22,35,3,10,2009-12-12,87,30,3,2,2,1,0,0,13,7,1,1
9146,11,17,23,24,25,3,6,2009-12-14,100,14,4,1,3,1,2,1,9,3,1,0
9147,6,12,18,22,29,5,8,2009-12-16,87,23,1,2,2,1,0,0,13,3,1,1
9148,2,4,13,14,33,1,9,2009-12-19,66,31,2,2,2,1,1,0,10,8,2,1
9149,1,3,10,12,20,2,7,2009-12-21,46,19,2,4,1,0,0,0,9,5,1,1
9150,4,11,18,25,34,5,7,2009-12-23,92,30,2,2,1,2,0,0,12,2,2,1
9151,3,8,14,30,31,4,9,2009-12-26,86,28,2,2,1,2,1,0,13,5,1,1
9152,1,23,29,30,32,7,12,2009-12-28,115,31,3,1,1,3,1,1,19,5,1,1
9153,21,22,30,32,34,3,7,2009-12-30,139,13,1,0,2,3,1,2,10,4,2,1
10001,2,6,7,12,27,2,8,2010-01-02,54,25,2,4,0,1,1,0,10,6,0,1
10002,4,23,25,26,30,7,10,2010-01-04,108,26,2,1,1,3,1,0,17,3,1,1
10003,5,14,23,27,30,2,8,2010-01-06,99,25,3,1,2,2,0,2,10,6,0,1
10004,3,6,21,24,34,4,6,2010-01-09,88,31,2,2,2,1,0,0,10,2,0,0
10005,4,17,19,22,30,2,3,2010-01-11,92,26,2,1,3,1,0,0,5,1,1,0
10006,3,13,19,30,34,2,5,2010-01-13,99,31,3,1,2,2,0,2,7,3,1,0
10007,7,23,26,29,32,8,11,2010-01-16,117,25,3,1,1,3,0,0,19,3,1,1
10008,11,23,25,31,32,5,11,2010-01-18,122,21,4,1,1,3,1,2,16,6,2,1
10009,2,5,13,27,32,3,11,2010-01-20,79,30,3,2,1,2,0,1,14,8,2,1
10010,15,22,24,32,35,2,9,2010-01-23,128,20,2,0,3,2,0,1,11,7,1,1
10011,2,3,11,27,32,8,11,2010-01-25,75,30,3,3,0,2,1,1,19,3,1,1
10012,20,24,30,31,33,5,12,2010-01-27,138,13,2,0,2,3,1,0,17,7,1,1
10013,18,21,22,26,34,9,12,2010-01-30,121,16,1,0,3,2,1,0,21,3,1,1
10014,18,19,30,33,35,2,4,2010-02-01,135,17,3,0,2,3,1,1,6,2,0,0
10015,3,10,14,18,28,8,10,2010-02-03,73,25,1,2,2,1,0,1,18,2,0,1
10016,10,12,20,23,32,4,10,2010-02-06,97,22,1,2,2,1,0,1,14,6,0,1
10017,13,21,23,27,34,9,12,2010-02-08,118,21,4,0,3,2,0,1,21,3,1,1
10018,3,10,26,32,33,4,12,2010-02-10,104,30,2,2,0,3,1,0,16,8,0,1
10019,3,11,19,26,27,2,9,2010-02-20,86,24,4,2,1,2,1,2,11,7,1,1
10020,8,18,26,32,33,1,6,2010-02-22,117,25,1,1,1,3,1,1,7,5,1,0
10021,11,20,23,24,25,7,9,2010-02-24,103,14,3,1,3,1,2,0,16,2,2,1
10022,2,11,13,14,25,2,5,2010-02-27,65,23,3,2,2,1,1,2,7,3,1,0
10023,11,13,29,32,33,2,8,2010-03-01,118,22,4,1,1,3,1,2,10,6,0,1
10024,3,14,19,24,25,4,11,2010-03-03,85,22,3,1,3,1,1,0,15,7,1,1
10025,9,11,13,14,25,1,7,2010-03-06,72,16,4,2,2,1,1,2,8,6,2,1
10026,5,23,25,31,35,7,10,2010-03-08,119,30,5,1,1,3,0,1,17,3,1,1
10027,5,23,26,32,34,2,9,2010-03-10,120,29,2,1,1,3,0,2,11,7,1,1
10028,1,2,7,20,35,1,3,2010-03-13,65,34,3,3,1,1,1,0,4,2,2,0
10029,21,22,33,34,35,3,4,2010-03-15,145,14,3,0,2,3,3,1,7,1,1,0
10030,10,12,19,32,35,2,7,2010-03-17,108,25,2,2,1,2,0,1,9,5,1,1
10031,5,13,16,17,35,6,8,2010-03-20,86,30,4,1,3,1,1,1,14,2,0,1
10032,13,16,23,24,33,7,11,2010-03-22,109,20,3,0,4,1,1,2,18,4,2,1
10033,12,19,28,29,30,5,8,2010-03-24,118,18,2,1,1,3,2,0,13,3,1,1
10034,1,6,19,25,26,3,9,2010-03-27,77,25,3,2,1,2,1,1,12,6,2,1
10035,14,16,20,31,34,1,7,2010-03-29,115,20,1,0,3,2,0,0,8,6,2,1
10036,19,25,28,31,33,1,8,2010-03-31,136,14,4,0,1,4,0,1,9,7,1,1
10037,19,21,26,34,35,1,9,2010-04-03,135,16,3,0,2,3,1,1,10,8,2,1
10038,8,10,25,29,33,1,2,2010-04-05,105,25,3,2,0,3,0,0,3,1,1,0
10039,7,19,26,28,32,1,8,2010-04-07,112,25,2,1,1,3,0,0,9,7,1,1
10040,13,20,26,31,35,2,11,2010-04-10,125,22,3,0,2,3,0,1,13,9,1,1
10041,16,22,28,29,34,4,12,2010-04-12,129,18,1,0,2,3,1,0,16,8,0,1
10042,1,5,19,34,35,6,7,2010-04-14,94,34,4,2,1,2,1,1,13,1,1,1
10043,5,8,10,33,35,2,10,2010-04-17,91,30,3,3,0,2,0,2,12,8,0,1
10044,6,21,24,28,30,2,7,2010-04-19,109,24,1,1,2,2,0,0,9,5,1,1
10045,8,17,18,20,28,9,10,2010-04-21,91,20,1,1,3,1,1,1,19,1,1,1
10046,2,15,19,26,27,5,6,2010-04-24,89,25,3,1,2,2,1,0,11,1,1,0
10047,4,8,11,30,31,2,8,2010-04-26,84,27,2,3,0,2,1,0,10,6,0,1
10048,2,3,10,12,25,3,9,2010-04-28,52,23,2,4,0,1,1,0,12,6,2,1
10049,1,25,29,31,33,4,10,2010-05-01,119,32,5,1,0,4,0,1,14,6,0,1
10050,7,8,15,30,35,5,10,2010-05-03,95,28,3,2,1,2,1,0,15,5,1,1
10051,6,10,20,24,32,6,10,2010-05-05,92,26,0,2,2,1,0,0,16,4,0,1
10052,4,6,25,29,32,5,6,2010-05-08,96,28,2,2,0,3,0,2,11,1,1,0
10053,9,19,22,26,34,9,11,2010-05-10,110,25,2,1,2,2,0,0,20,2,2,1
10054,12,25,29,30,33,10,11,2010-05-12,129,21,3,1,0,4,1,0,21,1,1,1
10055,13,14,17,27,32,2,10,2010-05-15,103,19,3,0,3,2,1,0,12,8,0,1
10056,5,9,23,25,30,9,12,2010-05-17,92,25,4,2,1,2,0,0,21,3,1,1
10057,15,17,24,32,35,7,9,2010-05-19,123,20,3,0,3,2,0,0,16,2,2,1
10058,6,15,17,19,30,1,12,2010-05-22,87,24,3,1,3,1,0,2,13,11,1,1
10059,6,10,14,25,34,1,3,2010-05-24,89,28,1,2,1,2,0,1,4,2,2,0
10060,10,13,22,33,34,1,5,2010-05-26,112,24,2,1,2,2,1,2,6,4,2,0
10061,5,12,14,17,22,5,7,2010-05-29,70,17,2,2,3,0,0,1,12,2,2,1
10062,6,7,18,30,31,7,8,2010-05-31,92,25,2,2,1,2,2,0,15,1,1,1
10063,7,14,16,30,31,3,6,2010-06-02,98,24,2,1,2,2,1,3,9,3,1,0
10064,7,10,12,20,21,6,9,2010-06-05,70,14,2,3,2,0,1,1,15,3,1,1
10065,5,8,13,14,32,8,11,2010-06-07,72,27,2,2,2,1,1,0,19,3,1,1
10066,15,21,22,24,27,1,6,2010-06-09,109,12,3,0,4,1,1,0,7,5,1,0
10067,1,11,19,30,32,3,10,2010-06-12,93,31,3,2,1,2,0,0,13,7,1,1
10068,11,17,19,20,34,6,10,2010-06-14,101,23,3,1,3,1,1,2,16,4,0,1
10069,6,17,18,25,29,8,9,2010-06-16,95,23,3,1,2,2,1,1,17,1,1,1
10070,5,14,23,25,28,11,12,2010-06-19,95,23,3,1,2,2,0,1,23,1,1,1
10071,7,12,26,30,32,2,7,2010-06-21,107,25,1,2,0,3,0,0,9,5,1,1
10072,5,10,17,23,25,3,10,2010-06-23,80,20,4,2,2,1,0,0,13,7,1,1
10073,4,9,11,30,32,1,11,2010-06-26,86,28,2,3,0,2,0,0,12,10,2,1
10074,3,7,20,27,32,2,12,2010-06-28,89,29,3,2,1,2,0,1,14,10,0,1
10075,10,12,17,23,27,5,7,2010-06-30,89,17,3,2,2,1,0,1,12,2,2,1
10076,9,12,16,19,35,2,12,2010-07-03,91,26,3,2,2,1,0,1,14,10,0,1
10077,6,7,9,17,24,2,12,2010-07-05,63,18,3,3,2,0,1,1,14,10,0,1
10078,2,3,15,28,35,1,11,2010-07-07,83,33,3,2,1,2,1,0,12,10,2,1
10079,1,4,21,22,24,2,5,2010-07-10,72,23,2,2,3,0,1,0,7,3,1,0
10080,8,19,27,29,34,4,10,2010-07-12,117,26,3,1,1,3,0,0,14,6,0,1
10081,14,18,20,24,27,5,10,2010-07-14,103,13,1,0,4,1,0,1,15,5,1,1
10082,5,8,24,29,30,4,6,2010-07-17,96,25,2,2,1,2,1,1,10,2,0,0
10083,7,11,21,22,35,4,7,2010-07-19,96,28,4,2,2,1,1,0,11,3,1,1
10084,3,13,14,22,26,2,5,2010-07-21,78,23,2,1,3,1,1,1,7,3,1,0
10085,2,10,16,18,34,2,3,2010-07-24,80,32,0,2,2,1,0,0,5,1,1,0
10086,1,2,12,19,35,5,7,2010-07-26,69,34,3,3,1,1,1,1,12,2,2,1
10087,1,12,20,21,24,2,8,2010-07-28,78,23,2,2,3,0,1,2,10,6,0,1
10088,3,5,14,30,35,3,6,2010-07-31,87,32,3,2,1,2,0,0,9,3,1,0
10089,4,10,13,18,23,8,10,2010-08-02,68,19,2,2,3,0,0,0,18,2,0,1
10090,8,24,26,31,32,7,9,2010-08-04,121,24,1,1,1,3,1,0,16,2,2,1
10091,6,10,23,26,31,5,7,2010-08-07,96,25,2,2,1,2,0,2,12,2,2,1
10092,2,15,29,30,34,2,12,2010-08-09,110,32,2,1,1,3,1,0,14,10,0,1
10093,2,4,9,28,29,5,8,2010-08-11,72,27,2,3,0,2,1,2,13,3,1,1
10094,20,32,33,34,35,6,7,2010-08-14,154,15,2,0,1,4,3,0,13,1,1,1
10095,12,14,16,19,25,1,6,2010-08-16,86,13,2,1,3,1,0,0,7,5,1,0
10096,4,9,24,30,35,1,10,2010-08-18,102,31,2,2,1,2,0,0,11,9,1,1
10097,9,17,21,28,29,2,8,2010-08-21,104,20,4,1,2,2,1,1,10,6,0,1
10098,2,3,12,13,25,1,7,2010-08-23,55,23,3,3,1,1,2,0,8,6,2,1
10099,3,11,17,21,30,1,8,2010-08-25,82,27,4,2,2,1,0,1,9,7,1,1
10100,19,20,30,33,35,6,8,2010-08-28,137,16,3,0,2,3,1,1,14,2,0,1
10101,11,15,22,27,35,5,8,2010-08-30,110,24,4,1,2,2,0,1,13,3,1,1
10102,4,15,19,24,35,1,10,2010-09-01,97,31,3,1,3,1,0,2,11,9,1,1
10103,10,14,29,30,35,5,8,2010-09-04,118,25,2,1,1,3,1,1,13,3,1,1
10104,14,25,30,32,33,1,11,2010-09-06,134,19,2,0,1,4,1,2,12,10,2,1
10105,5,17,26,27,35,8,9,2010-09-08,110,30,4,1,1,3,1,0,17,1,1,1
10106,5,27,28,29,34,9,12,2010-09-11,123,29,3,1,0,4,2,2,21,3,1,1
10107,14,17,22,27,34,3,5,2010-09-13,114,20,2,0,3,2,0,2,8,2,2,0
10108,1,10,13,19,34,9,12,2010-09-15,77,33,3,2,2,1,0,1,21,3,1,1
10109,1,2,8,11,25,10,12,2010-09-18,47,24,3,4,0,1,1,1,22,2,0,1
10110,21,29,30,33,35,7,11,2010-09-20,148,14,4,0,1,4,1,0,18,4,2,1
10111,3,6,13,14,29,1,2,2010-09-22,65,26,3,2,2,1,1,1,3,1,1,0
10112,14,15,18,34,35,8,10,2010-09-25,116,21,2,0,3,2,2,1,18,2,0,1
10113,5,16,22,23,32,4,10,2010-09-27,98,27,2,1,3,1,1,0,14,6,0,1
10114,3,7,22,25,35,3,11,2010-09-29,92,32,4,2,1,2,0,1,14,8,2,1
10115,5,7,10,15,32,3,8,2010-10-02,69,27,3,3,1,1,0,1,11,5,1,1
10116,14,22,27,28,35,4,10,2010-10-04,126,21,2,0,2,3,1,0,14,6,0,1
10117,4,6,21,27,34,5,9,2010-10-06,92,30,2,2,1,2,0,1,14,4,2,1
10118,19,22,23,29,35,8,10,2010-10-09,128,16,4,0,3,2,1,0,18,2,0,1
10119,5,13,14,23,26,2,3,2010-10-11,81,21,3,1,3,1,1,1,5,1,1,0
10120,8,10,18,34,35,6,10,2010-10-13,105,27,1,2,1,2,1,0,16,4,0,1
10121,21,22,31,32,34,2,12,2010-10-16,140,13,2,0,2,3,2,1,14,10,0,1
10122,5,6,11,13,26,2,7,2010-10-18,61,21,3,3,1,1,1,0,9,5,1,1
10123,18,20,30,32,33,1,11,2010-10-20,133,15,1,0,2,3,1,0,12,10,2,1
10124,1,9,27,29,34,1,6,2010-10-23,100,33,4,2,0,3,0,0,7,5,1,0
10125,1,7,9,14,19,9,12,2010-10-25,50,18,4,3,2,0,0,2,21,3,1,1
10126,3,5,9,13,33,5,11,2010-10-27,63,30,5,3,1,1,0,1,16,6,2,1
10127,3,22,24,30,33,4,10,2010-10-30,112,30,2,1,2,2,0,2,14,6,0,1
10128,6,17,19,29,35,2,8,2010-11-01,106,29,4,1,2,2,0,0,10,6,0,1
10129,14,15,24,25,26,3,7,2010-11-03,104,12,2,0,3,2,3,0,10,4,2,1
10130,5,6,9,10,34,8,11,2010-11-06,64,29,2,4,0,1,2,0,19,3,1,1
10131,10,15,22,28,29,4,12,2010-11-08,104,19,2,1,2,2,1,1,16,8,0,1
10132,18,21,23,25,29,6,11,2010-11-10,116,11,4,0,3,2,0,1,17,5,1,1
10133,11,16,17,21,22,3,6,2010-11-13,87,11,3,1,4,0,2,1,9,3,1,0
10134,9,12,13,19,30,4,5,2010-11-15,83,21,3,2,2,1,1,0,9,1,1,0
10135,14,17,19,26,32,3,4,2010-11-17,108,18,2,0,3,2,0,1,7,1,1,0
10136,3,13,18,30,33,7,8,2010-11-20,97,30,3,1,2,2,0,0,15,1,1,1
10137,22,27,28,33,35,9,11,2010-11-22,145,13,3,0,1,4,1,1,20,2,2,1
10138,8,12,14,19,27,5,6,2010-11-24,80,19,2,2,2,1,0,1,11,1,1,0
10139,3,13,16,19,29,7,9,2010-11-27,80,26,4,1,3,1,0,1,16,2,2,1
10140,6,18,20,30,31,3,6,2010-11-29,105,25,1,1,2,2,1,0,9,3,1,0
10141,5,11,17,23,33,3,10,2010-12-01,89,28,5,2,2,1,0,0,13,7,1,1
10142,10,11,19,21,27,4,6,2010-12-04,88,17,4,2,2,1,1,1,10,2,0,0
10143,10,16,18,22,27,6,8,2010-12-06,93,17,1,1,3,1,0,2,14,2,0,1
10144,2,11,16,22,31,10,11,2010-12-08,82,29,2,2,2,1,0,2,21,1,1,1
10145,18,19,27,28,33,3,6,2010-12-11,125,15,3,0,2,3,2,0,9,3,1,0
10146,14,17,30,31,34,4,10,2010-12-13,126,20,2,0,2,3,1,0,14,6,0,1
10147,1,15,19,21,23,11,12,2010-12-15,79,22,5,1,4,0,0,0,23,1,1,1
10148,3,4,8,10,35,2,6,2010-12-18,60,32,2,4,0,1,1,0,8,4,0,0
10149,5,22,24,25,30,1,6,2010-12-20,106,25,2,1,2,2,1,0,7,5,1,0
10150,5,24,28,29,35,1,9,2010-12-22,121,30,3,1,1,3,1,2,10,8,2,1
10151,1,10,32,33,35,3,8,2010-12-25,111,34,3,2,0,3,1,1,11,5,1,1
10152,2,5,18,22,23,7,12,2010-12-27,70,21,2,2,3,0,1,0,19,5,1,1
10153,6,7,16,24,35,4,6,2010-12-29,88,29,2,2,2,1,1,0,10,2,0,0
11001,7,8,15,32,34,5,12,2011-01-01,96,27,2,2,1,2,1,1,17,7,1,1
11002,11,13,27,28,29,2,6,2011-01-03,108,18,4,1,1,3,2,0,8,4,0,0
11003,1,24,27,30,31,1,6,2011-01-05,113,30,3,1,1,3,1,1,7,5,1,0
11004,7,8,10,23,25,7,9,2011-01-08,73,18,3,3,1,1,1,0,16,2,2,1
11005,1,7,25,27,30,7,12,2011-01-10,90,29,4,2,0,3,0,2,19,5,1,1
11006,2,8,16,26,35,11,12,2011-01-12,87,33,1,2,1,2,0,0,23,1,1,1
11007,14,24,32,33,35,2,9,2011-01-15,138,21,2,0,2,3,1,1,11,7,1,1
11008,1,23,26,27,30,5,6,2011-01-17,107,29,3,1,1,3,1,0,11,1,1,0
11009,9,10,11,14,24,3,8,2011-01-19,68,15,2,3,2,0,2,0,11,5,1,1
11010,4,8,10,14,27,5,7,2011-01-22,63,23,1,3,1,1,0,2,12,2,2,1
11011,2,17,23,24,30,2,9,2011-01-24,96,28,2,1,3,1,1,0,11,7,1,1
11012,3,12,19,25,30,8,11,2011-01-26,89,27,3,2,1,2,0,1,19,3,1,1
11013,5,8,14,28,30,4,6,2011-01-29,85,25,1,2,1,2,0,1,10,2,0,0
11014,2,14,20,21,24,2,9,2011-01-31,81,22,1,1,4,0,1,1,11,7,1,1
11015,8,18,19,22,23,1,3,2011-02-09,90,15,2,1,4,0,2,0,4,2,2,0
11016,15,20,30,33,35,6,9,2011-02-12,133,20,3,0,2,3,0,0,15,3,1,1
11017,16,19,24,26,31,2,4,2011-02-14,116,15,2,0,3,2,0,0,6,2,0,0
11018,16,22,24,32,34,2,10,2011-02-16,128,18,0,0,3,2,0,2,12,8,0,1
11019,8,21,23,27,33,6,11,2011-02-19,112,25,4,1,2,2,0,0,17,5,1,1
11020,9,12,19,22,28,1,5,2011-02-21,90,19,2,2,2,1,0,0,6,4,2,0
11021,1,9,13,17,30,2,8,2011-02-23,70,29,4,2,2,1,0,1,10,6,0,1
11022,9,14,24,25,34,1,4,2011-02-26,106,25,2,1,2,2,1,1,5,3,1,0
11023,5,13,16,18,24,2,12,2011-02-28,76,19,2,1,4,0,0,1,14,10,0,1
11024,12,15,16,20,33,8,12,2011-03-02,96,21,2,1,3,1,1,1,20,4,0,1
11025,8,9,25,28,29,2,10,2011-03-05,99,21,3,2,0,3,2,0,12,8,0,1
11026,1,9,15,20,29,7,9,2011-03-07,74,28,4,2,2,1,0,2,16,2,2,1
11027,5,14,25,34,35,2,5,2011-03-09,113,30,3,1,1,3,1,0,7,3,1,0
11028,1,2,13,17,28,1,4,2011-03-12,61,27,3,2,2,1,1,0,5,3,1,0
11029,3,9,17,24,28,6,12,2011-03-14,81,25,3,2,2,1,0,2,18,6,0,1
11030,15,19,25,30,33,3,8,2011-03-16,122,18,4,0,2,3,0,0,11,5,1,1
11031,12,17,19,22,35,4,11,2011-03-19,105,23,3,1,3,1,0,1,15,7,1,1
11032,7,16,23,31,33,3,10,2011-03-21,110,26,4,1,2,2,0,0,13,7,1,1
11033,3,19,24,29,33,3,9,2011-03-23,108,30,4,1,2,2,0,1,12,6,2,1
11034,3,6,9,17,27,3,9,2011-03-26,62,24,4,3,1,1,0,1,12,6,2,1
11035,3,4,13,15,32,4,9,2011-03-28,67,29,3,2,2,1,1,1,13,5,1,1
11036,3,18,29,30,33,8,9,2011-03-30,113,30,3,1,1,3,1,1,17,1,1,1
11037,1,12,14,22,24,10,12,2011-04-02,73,23,1,2,3,0,0,0,22,2,0,1
11038,7,9,11,13,33,10,12,2011-04-04,73,26,5,3,1,1,0,0,22,2,0,1
11039,1,11,14,22,34,6,8,2011-04-06,82,33,2,2,2,1,0,1,14,2,0,1
11040,3,7,15,18,20,1,6,2011-04-09,63,17,3,2,3,0,0,0,7,5,1,0
11041,4,5,11,13,25,3,6,2011-04-11,58,21,4,3,1,1,1,0,9,3,1,0
11042,6,9,18,30,32,10,12,2011-04-13,95,26,1,2,1,2,0,0,22,2,0,1
11043,2,8,23,33,35,5,10,2011-04-16,101,33,3,2,1,2,0,0,15,5,1,1
11044,11,21,24,26,31,6,7,2011-04-18,113,20,3,1,2,2,0,0,13,1,1,1
11045,13,21,22,29,31,7,11,2011-04-20,116,18,4,0,3,2,1,2,18,4,2,1
11046,9,15,16,19,29,4,6,2011-04-23,88,20,4,1,3,1,1,1,10,2,0,0
11047,2,15,22,33,35,5,8,2011-04-25,107,33,3,1,2,2,0,1,13,3,1,1
11048,13,17,25,27,28,2,3,2011-04-27,110,15,4,0,2,3,1,0,5,1,1,0
11049,5,6,10,22,25,1,9,2011-04-30,68,20,2,3,1,1,1,1,10,8,2,1
11050,4,7,29,32,33,8,10,2011-05-02,105,29,3,2,0,3,1,0,18,2,0,1
11051,6,8,12,17,18,5,10,2011-05-04,61,12,1,3,2,0,1,0,15,5,1,1
11052,13,24,31,32,33,3,9,2011-05-07,133,20,3,0,2,3,2,0,12,6,2,1
11053,3,16,28,31,32,1,9,2011-05-09,110,29,2,1,1,3,1,2,10,8,2,1
11054,5,9,16,26,35,3,10,2011-05-11,91,30,3,2,1,2,0,1,13,7,1,1
11055,1,7,31,32,35,2,10,2011-05-14,106,34,4,2,0,3,1,1,12,8,0,1
11056,3,5,29,30,31,8,10,2011-05-16,98,28,4,2,0,3,2,1,18,2,0,1
11057,7,11,30,31,34,9,12,2011-05-18,113,27,3,2,0,3,1,2,21,3,1,1
11058,1,9,27,32,33,3,6,2011-05-21,102,32,4,2,0,3,1,0,9,3,1,0
11059,9,16,21,29,34,7,10,2011-05-23,109,25,3,1,2,2,0,1,17,3,1,1
11060,3,25,29,32,34,9,10,2011-05-25,123,31,3,1,0,4,0,2,19,1,1,1
11061,6,7,16,18,20,4,10,2011-05-28,67,14,1,2,3,0,1,0,14,6,0,1
11062,6,10,17,20,21,3,7,2011-05-30,74,15,2,2,3,0,1,2,10,4,2,1
11063,10,17,18,26,32,1,5,2011-06-01,103,22,1,1,2,2,1,2,6,4,2,0
11064,1,6,27,30,34,1,6,2011-06-04,98,33,2,2,0,3,0,0,7,5,1,0
11065,3,11,14,25,34,1,4,2011-06-06,87,31,3,2,1,2,0,1,5,3,1,0
11066,6,13,18,20,33,9,10,2011-06-08,90,27,2,1,3,1,0,0,19,1,1,1
11067,10,17,22,24,32,3,10,2011-06-11,105,22,1,1,3,1,0,0,13,7,1,1
11068,1,13,16,18,32,7,9,2011-06-13,80,31,2,1,3,1,0,1,16,2,2,1
11069,3,5,28,29,33,4,12,2011-06-15,98,30,4,2,0,3,1,0,16,8,0,1
11070,9,19,22,29,30,2,8,2011-06-18,109,21,3,1,2,2,1,1,10,6,0,1
11071,27,31,33,34,35,4,6,2011-06-20,160,8,4,0,0,5,2,0,10,2,0,0
11072,3,11,13,20,35,3,8,2011-06-22,82,32,4,2,2,1,0,1,11,5,1,1
11073,13,19,20,22,33,5,11,2011-06-25,107,20,3,0,4,1,1,2,16,6,2,1
11074,7,16,23,28,31,3,6,2011-06-27,105,24,3,1,2,2,0,0,9,3,1,0
11075,6,9,20,23,28,6,10,2011-06-29,86,22,2,2,2,1,0,2,16,4,0,1
11076,18,23,25,29,30,1,2,2011-07-02,125,12,3,0,2,3,1,1,3,1,1,0
11077,5,8,19,33,34,1,12,2011-07-04,99,29,3,2,1,2,1,0,13,11,1,1
11078,4,9,16,27,30,2,6,2011-07-06,86,26,2,2,1,2,0,0,8,4,0,0
11079,1,3,23,30,31,2,10,2011-07-09,88,30,4,2,1,2,1,1,12,8,0,1
11080,5,12,30,31,32,1,3,2011-07-11,110,27,2,2,0,3,2,2,4,2,2,0
11081,4,13,20,21,35,2,9,2011-07-13,93,31,3,1,3,1,1,0,11,7,1,1
11082,7,20,25,30,32,5,9,2011-07-16,114,25,2,1,1,3,0,1,14,4,2,1
11083,6,8,18,20,24,4,8,2011-07-18,76,18,0,2,3,0,0,1,12,4,0,1
11084,14,29,31,34,35,1,12,2011-07-20,143,21,3,0,1,4,1,0,13,11,1,1
11085,2,17,19,21,22,3,10,2011-07-23,81,20,3,1,4,0,1,0,13,7,1,1
11086,4,5,6,9,15,1,6,2011-07-25,39,11,3,4,1,0,2,0,7,5,1,0
11087,6,13,20,25,34,7,9,2011-07-27,98,28,2,1,2,2,0,1,16,2,2,1
11088,20,21,27,29,35,3,8,2011-07-30,132,15,4,0,2,3,1,1,11,5,1,1
11089,5,6,23,27,34,3,4,2011-08-01,95,29,3,2,1,2,1,1,7,1,1,0
11090,2,4,29,30,34,5,8,2011-08-03,99,32,1,2,0,3,1,1,13,3,1,1
11091,11,17,23,29,30,6,8,2011-08-06,110,19,4,1,2,2,1,2,14,2,0,1
11092,10,17,19,32,33,1,12,2011-08-08,111,23,3,1,2,2,1,1,13,11,1,1
11093,4,6,8,19,31,10,11,2011-08-10,68,27,2,3,1,1,0,1,21,1,1,1
11094,11,21,22,32,34,4,8,2011-08-13,120,23,2,1,2,2,1,0,12,4,0,1
11095,9,12,17,19,29,6,11,2011-08-15,86,20,4,2,2,1,0,0,17,5,1,1
11096,3,8,20,24,25,1,2,2011-08-17,80,22,2,2,2,1,1,0,3,1,1,0
11097,4,19,28,31,33,11,12,2011-08-20,115,29,3,1,1,3,0,0,23,1,1,1
11098,6,7,28,33,35,1,10,2011-08-22,109,29,3,2,0,3,1,2,11,9,1,1
11099,2,6,9,12,20,5,8,2011-08-24,49,18,1,4,1,0,0,1,13,3,1,1
11100,8,11,13,28,33,8,9,2011-08-27,93,25,3,2,1,2,0,0,17,1,1,1
11101,5,12,20,28,30,3,7,2011-08-29,95,25,1,2,1,2,0,1,10,4,2,1
11102,19,24,28,31,34,4,12,2011-08-31,136,15,2,0,2,3,0,1,16,8,0,1
11103,3,4,26,29,34,1,3,2011-09-03,96,31,2,2,0,3,1,1,4,2,2,0
11104,7,19,27,28,34,2,5,2011-09-05,115,27,3,1,1,3,1,1,7,3,1,0
11105,2,11,26,32,33,5,12,2011-09-07,104,31,2,2,0,3,1,0,17,7,1,1
11106,1,9,29,30,35,5,9,2011-09-10,104,34,4,2,0,3,1,0,14,4,2,1
11107,2,6,18,30,32,1,8,2011-09-12,88,30,0,2,1,2,0,1,9,7,1,1
11108,7,15,18,24,28,1,7,2011-09-14,92,21,2,1,3,1,0,1,8,6,2,1
11109,1,11,12,22,34,8,10,2011-09-17,80,33,2,3,1,1,1,0,18,2,0,1
11110,30,31,33,34,35,4,7,2011-09-19,163,5,3,0,0,5,3,1,11,3,1,1
11111,2,11,13,23,31,11,12,2011-09-21,80,29,4,2,2,1,0,1,23,1,1,1
11112,6,17,28,32,33,8,12,2011-09-24,116,27,2,1,1,3,1,0,20,4,0,1
11113,4,5,7,10,12,4,5,2011-09-26,38,8,2,5,0,0,1,0,9,1,1,0
11114,6,8,17,27,35,2,11,2011-09-28,93,29,3,2,1,2,0,0,13,9,1,1
11115,17,26,30,31,35,6,11,2011-10-01,139,18,3,0,1,4,1,2,17,5,1,1
11116,10,15,18,19,26,7,12,2011-10-03,88,16,2,1,3,1,1,1,19,5,1,1
11117,10,12,28,32,33,3,5,2011-10-05,115,23,1,2,0,3,1,1,8,2,2,0
11118,4,7,11,32,35,5,7,2011-10-08,89,31,3,3,0,2,0,1,12,2,2,1
11119,4,15,20,26,31,6,12,2011-10-10,96,27,2,1,2,2,0,1,18,6,0,1
11120,20,25,26,30,31,9,10,2011-10-12,132,11,2,0,1,4,2,3,19,1,1,1
11121,2,3,30,31,33,3,9,2011-10-15,99,31,3,2,0,3,2,2,12,6,2,1
11122,3,8,23,24,34,5,12,2011-10-17,92,31,2,2,2,1,1,1,17,7,1,1
11123,10,14,18,19,35,1,6,2011-10-19,96,25,2,1,3,1,1,0,7,5,1,0
11124,8,12,14,20,25,6,8,2011-10-22,79,17,1,2,2,1,0,1,14,2,0,1
11125,7,10,27,34,35,10,12,2011-10-24,113,28,3,2,0,3,1,0,22,2,0,1
11126,7,17,29,30,33,10,12,2011-10-26,116,26,4,1,1,3,1,1,22,2,0,1
11127,1,11,22,26,29,5,8,2011-10-29,89,28,3,2,1,2,0,1,13,3,1,1
11128,3,4,6,11,13,1,2,2011-10-31,37,10,3,4,1,0,1,1,3,1,1,0
11129,1,7,13,18,23,4,8,2011-11-02,62,22,4,2,3,0,0,1,12,4,0,1
11130,8,9,13,23,35,11,12,2011-11-05,88,27,4,2,2,1,1,2,23,1,1,1
11131,3,5,12,18,33,7,11,2011-11-07,71,30,3,3,1,1,0,0,18,4,2,1
11132,12,14,16,19,33,2,9,2011-11-09,94,21,2,1,3,1,0,2,11,7,1,1
11133,4,11,23,26,35,3,12,2011-11-12,99,31,3,2,1,2,0,0,15,9,1,1
11134,1,10,12,14,17,9,10,2011-11-14,54,16,2,3,2,0,0,0,19,1,1,1
11135,6,22,29,33,35,3,12,2011-11-16,125,29,3,1,1,3,0,0,15,9,1,1
11136,8,9,11,19,33,3,12,2011-11-19,80,25,4,3,1,1,1,1,15,9,1,1
11137,2,15,18,23,31,1,2,2011-11-21,89,29,3,1,3,1,0,0,3,1,1,0
11138,17,23,26,30,32,6,12,2011-11-23,128,15,2,0,2,3,0,1,18,6,0,1
11139,4,6,10,15,16,3,4,2011-11-26,51,12,1,3,2,0,1,0,7,1,1,0
11140,1,12,32,33,34,9,11,2011-11-28,112,33,2,2,0,3,2,0,20,2,2,1
11141,2,11,19,22,35,10,12,2011-11-30,89,33,3,2,2,1,0,0,22,2,0,1
11142,4,26,30,33,34,4,6,2011-12-03,127,30,1,1,0,4,1,0,10,2,0,0
11143,8,9,12,25,33,7,10,2011-12-05,87,25,3,3,0,2,1,1,17,3,1,1
11144,7,18,24,28,33,2,3,2011-12-07,110,26,2,1,2,2,0,1,5,1,1,0
11145,7,15,19,24,29,4,6,2011-12-10,94,22,4,1,3,1,0,2,10,2,0,0
11146,9,13,19,29,34,2,11,2011-12-12,104,25,4,1,2,2,0,2,13,9,1,1
11147,1,15,16,27,28,2,7,2011-12-14,87,27,3,1,2,2,2,0,9,5,1,1
11148,7,10,11,26,31,3,4,2011-12-17,85,24,3,3,0,2,1,0,7,1,1,0
11149,2,7,12,29,31,3,5,2011-12-19,81,29,3,3,0,2,0,2,8,2,2,0
11150,13,22,30,33,34,6,12,2011-12-21,132,21,2,0,2,3,1,0,18,6,0,1
11151,7,11,14,20,27,3,10,2011-12-24,79,20,3,2,2,1,0,0,13,7,1,1
11152,1,4,6,21,35,2,11,2011-12-26,67,34,3,3,1,1,0,0,13,9,1,1
11153,6,22,29,30,35,3,5,2011-12-28,122,29,2,1,1,3,1,2,8,2,2,0
11154,4,12,16,20,28,8,11,2011-12-31,80,24,0,2,2,1,0,0,19,3,1,1
12001,7,27,28,32,33,1,12,2012-01-02,127,26,3,1,0,4,2,1,13,11,1,1
12002,3,11,14,26,29,7,8,2012-01-04,83,26,3,2,1,2,0,0,15,1,1,1
12003,16,22,24,33,34,3,10,2012-01-07,129,18,1,0,3,2,1,0,13,7,1,1
12004,10,11,22,31,32,6,7,2012-01-09,106,22,2,2,1,2,2,1,13,1,1,1
12005,1,2,29,31,33,7,12,2012-01-11,96,32,4,2,0,3,1,1,19,5,1,1
12006,3,20,22,25,27,1,9,2012-01-14,97,24,3,1,2,2,0,0,10,8,2,1
12007,4,5,13,17,25,7,10,2012-01-16,64,21,4,2,2,1,1,1,17,3,1,1
12008,6,8,30,31,32,1,11,2012-01-18,107,26,1,2,0,3,2,0,12,10,2,1
12009,6,14,20,29,35,9,10,2012-01-21,104,29,2,1,2,2,0,1,19,1,1,1
12010,25,26,29,32,34,5,7,2012-01-30,146,9,2,0,0,5,1,1,12,2,2,1
12011,5,19,22,29,30,2,4,2012-02-01,105,25,3,1,2,2,1,1,6,2,0,0
12012,6,18,22,30,35,2,7,2012-02-04,111,29,1,1,2,2,0,2,9,5,1,1
12013,7,8,11,12,24,1,2,2012-02-06,62,17,2,4,1,0,2,0,3,1,1,0
12014,10,14,24,30,32,1,12,2012-02-08,110,22,0,1,2,2,0,1,13,11,1,1
12015,12,13,24,26,33,6,8,2012-02-11,108,21,2,1,2,2,1,1,14,2,0,1
12016,5,14,20,29,31,8,12,2012-02-13,99,26,3,1,2,2,0,0,20,4,0,1
12017,6,11,22,29,34,3,12,2012-02-15,102,28,2,2,1,2,0,1,15,9,1,1
12018,3,10,14,29,31,4,8,2012-02-18,87,28,3,2,1,2,0,1,12,4,0,1
12019,7,9,17,30,34,1,12,2012-02-20,97,27,3,2,1,2,0,0,13,11,1,1
12020,12,14,27,29,34,3,6,2012-02-22,116,22,2,1,1,3,0,1,9,3,1,0
12021,10,15,21,31,34,7,8,2012-02-25,111,24,3,1,2,2,0,1,15,1,1,1
12022,7,12,20,33,35,1,10,2012-02-27,107,28,3,2,1,2,0,0,11,9,1,1
12023,7,9,17,29,35,9,10,2012-02-29,97,28,5,2,1,2,0,2,19,1,1,1
12024,3,11,17,21,30,3,7,2012-03-03,82,27,4,2,2,1,0,1,10,4,2,1
12025,1,2,5,12,27,4,7,2012-03-05,47,26,3,4,0,1,1,0,11,3,1,1
12026,10,11,22,23,29,2,9,2012-03-07,95,19,3,2,2,1,2,0,11,7,1,1
12027,3,10,11,22,31,5,7,2012-03-10,77,28,3,3,1,1,1,3,12,2,2,1
12028,10,12,15,33,34,3,10,2012-03-12,104,24,2,2,1,2,1,1,13,7,1,1
12029,4,7,8,18,29,7,10,2012-03-14,66,25,2,3,1,1,1,0,17,3,1,1
12030,3,21,22,26,32,1,3,2012-03-17,104,29,2,1,2,2,1,0,4,2,2,0
12031,19,21,23,25,30,3,8,2012-03-19,118,11,4,0,3,2,0,1,11,5,1,1
12032,7,8,16,26,34,7,11,2012-03-21,91,27,1,2,1,2,1,0,18,4,2,1
12033,8,13,19,27,32,1,8,2012-03-24,99,24,3,1,2,2,0,1,9,7,1,1
12034,1,8,15,16,29,8,9,2012-03-26,69,28,3,2,2,1,1,1,17,1,1,1
12035,1,4,30,32,35,8,12,2012-03-28,102,34,2,2,0,3,0,1,20,4,0,1
12036,1,9,20,30,31,8,12,2012-03-31,91,30,3,2,1,2,1,2,20,4,0,1
12037,9,13,27,31,35,3,10,2012-04-02,115,26,5,1,1,3,0,2,13,7,1,1
12038,11,23,25,31,35,1,3,2012-04-04,125,24,5,1,1,3,0,2,4,2,2,0
12039,15,21,22,24,35,1,5,2012-04-07,117,20,3,0,4,1,1,1,6,4,2,0
12040,2,13,23,28,29,1,5,2012-04-09,95,27,3,1,2,2,1,0,6,4,2,0
12041,1,2,13,22,23,2,10,2012-04-11,61,22,3,2,3,0,2,3,12,8,0,1
12042,7,24,27,28,35,7,12,2012-04-14,121,28,3,1,1,3,1,0,19,5,1,1
12043,1,6,25,31,34,3,9,2012-04-16,97,33,3,2,0,3,0,0,12,6,2,1
12044,3,4,14,32,35,1,2,2012-04-18,88,32,2,2,1,2,1,0,3,1,1,0
12045,5,11,17,20,28,11,12,2012-04-21,81,23,3,2,2,1,0,0,23,1,1,1
12046,4,8,19,23,27,4,11,2012-04-23,81,23,3,2,2,1,0,0,15,7,1,1
12047,5,7,17,30,34,3,10,2012-04-25,93,29,3,2,1,2,0,0,13,7,1,1
12048,6,9,26,30,35,5,6,2012-04-28,106,29,2,2,0,3,0,1,11,1,1,0
12049,9,18,22,27,31,10,12,2012-04-30,107,22,3,1,2,2,0,1,22,2,0,1
12050,13,17,22,28,29,1,10,2012-05-02,109,16,3,0,3,2,1,1,11,9,1,1
12051,1,2,17,18,33,5,12,2012-05-05,71,32,3,2,2,1,2,1,17,7,1,1
12052,10,20,26,31,33,10,12,2012-05-07,120,23,2,1,1,3,0,1,22,2,0,1
12053,11,12,26,28,31,7,12,2012-05-09,108,20,2,2,0,3,1,2,19,5,1,1
12054,1,16,18,27,30,10,11,2012-05-12,92,29,2,1,2,2,0,0,21,1,1,1
12055,7,22,26,32,33,1,8,2012-05-14,120,26,2,1,1,3,1,0,9,7,1,1
12056,11,21,23,26,34,7,9,2012-05-16,115,23,3,1,2,2,0,1,16,2,2,1
12057,1,2,14,33,34,3,5,2012-05-19,84,33,2,2,1,2,2,1,8,2,2,0
12058,13,21,29,31,35,4,12,2012-05-21,129,22,5,0,2,3,0,0,16,8,0,1
12059,9,13,19,21,27,3,4,2012-05-23,89,18,5,1,3,1,0,2,7,1,1,0
12060,2,16,21,24,30,6,10,2012-05-26,93,28,1,1,3,1,0,1,16,4,0,1
12061,5,10,14,27,33,7,9,2012-05-28,89,28,3,2,1,2,0,0,16,2,2,1
12062,21,32,33,34,35,8,9,2012-05-30,155,14,3,0,1,4,3,1,17,1,1,1
12063,11,25,26,29,35,1,2,2012-06-02,126,24,4,1,0,4,1,1,3,1,1,0
12064,9,12,13,15,30,9,10,2012-06-04,79,21,3,2,2,1,1,0,19,1,1,1
12065,10,22,28,29,34,5,11,2012-06-06,123,24,1,1,1,3,1,0,16,6,2,1
12066,1,20,25,29,33,4,6,2012-06-09,108,32,4,1,1,3,0,1,10,2,0,0
12067,20,22,27,30,33,1,2,2012-06-11,132,13,2,0,2,3,0,2,3,1,1,0
12068,1,21,31,32,35,3,6,2012-06-13,120,34,4,1,1,3,1,0,9,3,1,0
12069,2,4,22,25,34,2,11,2012-06-16,87,32,1,2,1,2,0,0,13,9,1,1
12070,9,22,23,32,34,6,8,2012-06-18,120,25,2,1,2,2,1,2,14,2,0,1
12071,13,23,29,31,34,6,8,2012-06-20,130,21,4,0,2,3,0,2,14,2,0,1
12072,4,8,17,22,25,4,10,2012-06-23,76,21,2,2,2,1,0,0,14,6,0,1
12073,18,23,29,33,34,2,7,2012-06-25,137,16,3,0,2,3,1,0,9,5,1,1
12074,10,22,23,30,32,1,7,2012-06-27,117,22,1,1,2,2,1,1,8,6,2,1
12075,7,9,10,18,22,5,10,2012-06-30,66,15,2,3,2,0,1,2,15,5,1,1
12076,2,14,16,22,24,2,5,2012-07-02,78,22,0,1,4,0,0,1,7,3,1,0
12077,10,30,32,33,34,2,3,2012-07-04,139,24,1,1,0,4,2,0,5,1,1,0
12078,1,2,23,25,35,5,12,2012-07-07,86,34,4,2,1,2,1,0,17,7,1,1
12079,1,5,25,32,33,1,10,2012-07-09,96,32,4,2,0,3,1,2,11,9,1,1
12080,11,12,14,25,28,2,5,2012-07-11,90,17,2,2,1,2,1,1,7,3,1,0
12081,10,16,17,30,35,1,8,2012-07-14,108,25,2,1,2,2,1,0,9,7,1,1
12082,2,4,9,10,15,8,10,2012-07-16,40,13,2,4,1,0,1,1,18,2,0,1
12083,16,19,28,29,31,5,8,2012-07-18,123,15,3,0,2,3,1,0,13,3,1,1
12084,21,24,27,29,31,1,2,2012-07-21,132,10,4,0,2,3,0,2,3,1,1,0
12085,7,18,29,31,33,10,12,2012-07-23,118,26,4,1,1,3,0,2,22,2,0,1
12086,3,20,25,29,32,5,10,2012-07-25,109,29,3,1,1,3,0,1,15,5,1,1
12087,1,6,7,21,31,4,11,2012-07-28,66,30,4,3,1,1,1,0,15,7,1,1
12088,13,17,24,30,35,2,10,2012-07-30,119,22,3,0,3,2,0,0,12,8,0,1
12089,6,12,21,29,32,6,11,2012-08-01,100,26,2,2,1,2,0,0,17,5,1,1
12090,2,21,27,29,33,2,10,2012-08-04,112,31,4,1,1,3,0,2,12,8,0,1
12091,3,10,28,31,33,1,9,2012-08-06,105,30,3,2,0,3,0,1,10,8,2,1
12092,8,9,23,25,31,2,12,2012-08-08,96,23,4,2,1,2,1,1,14,10,0,1
12093,2,16,21,31,33,4,11,2012-08-11,103,31,3,1,2,2,0,1,15,7,1,1
12094,2,14,23,32,35,1,10,2012-08-13,106,33,2,1,2,2,0,1,11,9,1,1
12095,6,9,22,27,30,8,12,2012-08-15,94,24,2,2,1,2,0,0,20,4,0,1
12096,5,10,19,24,35,8,9,2012-08-18,93,30,3,2,2,1,0,0,17,1,1,1
12097,9,17,24,29,32,1,2,2012-08-20,111,23,3,1,2,2,0,1,3,1,1,0
12098,2,11,28,29,30,6,12,2012-08-22,100,28,2,2,0,3,2,1,18,6,0,1
12099,12,18,24,25,32,2,12,2012-08-25,111,20,1,1,2,2,1,0,14,10,0,1
12100,7,9,13,19,27,1,3,2012-08-27,75,20,5,2,2,1,0,0,4,2,2,0
12101,2,5,8,9,31,3,7,2012-08-29,55,29,3,4,0,1,1,1,10,4,2,1
12102,2,4,6,13,35,4,8,2012-09-01,60,33,2,3,1,1,0,1,12,4,0,1
12103,2,9,18,23,24,1,4,2012-09-03,76,22,2,2,3,0,1,1,5,3,1,0
12104,16,18,24,25,27,4,9,2012-09-05,110,11,2,0,3,2,1,2,13,5,1,1
12105,5,6,14,15,31,6,8,2012-09-08,71,26,3,2,2,1,2,0,14,2,0,1
12106,15,23,25,29,31,9,10,2012-09-10,123,16,5,0,2,3,0,2,19,1,1,1
12107,4,7,9,22,33,1,3,2012-09-12,75,29,3,3,1,1,0,0,4,2,2,0
12108,6,7,12,24,35,2,6,2012-09-15,84,29,2,3,1,1,1,1,8,4,0,0
12109,1,22,30,32,35,9,11,2012-09-17,120,34,2,1,1,3,0,1,20,2,2,1
12110,1,11,17,19,26,5,12,2012-09-19,74,25,4,2,2,1,0,1,17,7,1,1
12111,1,24,25,30,33,4,11,2012-09-22,113,32,3,1,1,3,1,1,15,7,1,1
12112,1,2,28,31,35,5,7,2012-09-24,97,34,3,2,0,3,1,1,12,2,2,1
12113,3,10,22,27,29,3,12,2012-09-26,91,26,3,2,1,2,0,0,15,9,1,1
12114,3,6,21,33,35,1,7,2012-09-29,98,32,4,2,1,2,0,1,8,6,2,1
12115,1,6,13,19,23,6,9,2012-10-01,62,22,4,2,3,0,0,1,15,3,1,1
12116,1,11,18,20,22,7,10,2012-10-03,72,21,2,2,3,0,0,1,17,3,1,1
12117,1,12,18,21,33,7,8,2012-10-06,85,32,3,2,2,1,0,2,15,1,1,1
12118,5,17,25,30,33,1,12,2012-10-08,110,28,4,1,1,3,0,1,13,11,1,1
12119,5,6,9,19,32,6,9,2012-10-10,71,27,3,3,1,1,1,1,15,3,1,1
12120,2,10,21,23,29,3,4,2012-10-13,85,27,3,2,2,1,0,0,7,1,1,0
12121,7,18,20,29,30,5,6,2012-10-15,104,23,2,1,2,2,1,1,11,1,1,0
12122,23,24,25,29,31,3,12,2012-10-17,132,8,4,0,2,3,2,1,15,9,1,1
12123,5,8,18,30,33,1,9,2012-10-20,94,28,2,2,1,2,0,0,10,8,2,1
12124,7,11,19,20,35,5,10,2012-10-22,92,28,4,2,2,1,1,0,15,5,1,1
12125,6,14,17,22,35,1,2,2012-10-24,94,29,2,1,3,1,0,1,3,1,1,0
12126,13,14,21,28,29,5,10,2012-10-27,105,16,3,0,3,2,2,1,15,5,1,1
12127,12,13,14,25,35,10,12,2012-10-29,99,23,3,1,2,2,2,2,22,2,0,1
12128,9,10,19,30,31,4,11,2012-10-31,99,22,3,2,1,2,2,0,15,7,1,1
12129,1,7,21,28,31,3,9,2012-11-03,88,30,4,2,1,2,0,1,12,6,2,1
12130,14,19,23,29,30,6,7,2012-11-05,115,16,3,0,3,2,1,0,13,1,1,1
12131,2,16,18,27,30,8,12,2012-11-07,93,28,1,1,2,2,0,1,20,4,0,1
12132,5,8,21,25,33,1,11,2012-11-10,92,28,4,2,1,2,0,0,12,10,2,1
12133,5,7,13,29,30,1,5,2012-11-12,84,25,4,2,1,2,1,1,6,4,2,0
12134,1,6,18,32,35,2,7,2012-11-14,92,34,2,2,1,2,0,0,9,5,1,1
12135,3,5,17,18,33,6,7,2012-11-17,76,30,4,2,2,1,1,1,13,1,1,1
12136,2,23,29,30,31,1,4,2012-11-19,115,29,3,1,1,3,2,0,5,3,1,0
12137,3,12,20,21,27,1,6,2012-11-21,83,24,3,2,2,1,1,0,7,5,1,0
12138,13,17,27,31,33,6,12,2012-11-24,121,20,5,0,2,3,0,1,18,6,0,1
12139,9,10,12,22,25,4,11,2012-11-26,78,16,2,3,1,1,1,0,15,7,1,1
12140,7,17,27,28,29,9,10,2012-11-28,108,22,4,1,1,3,2,0,19,1,1,1
12141,3,11,19,23,34,2,12,2012-12-01,90,31,4,2,2,1,0,0,14,10,0,1
12142,15,19,29,34,35,7,10,2012-12-03,132,20,4,0,2,3,1,2,17,3,1,1
12143,9,27,29,30,31,3,6,2012-12-05,126,22,4,1,0,4,2,1,9,3,1,0
12144,11,13,14,21,29,1,10,2012-12-08,88,18,4,1,3,1,1,1,11,9,1,1
12145,5,22,31,33,35,6,9,2012-12-10,126,30,4,1,1,3,0,0,15,3,1,1
12146,1,10,13,17,26,6,8,2012-12-12,67,25,3,2,2,1,0,0,14,2,0,1
12147,2,3,17,19,33,2,9,2012-12-15,74,31,4,2,2,1,1,1,11,7,1,1
12148,4,16,27,29,34,6,11,2012-12-17,110,30,2,1,1,3,0,0,17,5,1,1
12149,2,10,23,33,34,5,10,2012-12-19,102,32,2,2,1,2,1,1,15,5,1,1
12150,2,14,18,24,31,2,3,2012-12-22,89,29,1,1,3,1,0,1,5,1,1,0
12151,3,19,20,24,33,3,4,2012-12-24,99,30,3,1,3,1,1,1,7,1,1,0
12152,4,17,26,33,34,2,8,2012-12-26,114,30,2,1,1,3,1,1,10,6,0,1
12153,8,9,10,13,22,5,10,2012-12-29,62,14,2,3,2,0,2,0,15,5,1,1
12154,3,26,27,31,32,3,9,2012-12-31,119,29,3,1,0,4,2,0,12,6,2,1
13001,6,9,11,31,32,5,11,2013-01-02,89,26,3,3,0,2,1,2,16,6,2,1
13002,4,20,27,31,32,6,12,2013-01-05,114,28,2,1,1,3,1,2,18,6,0,1
13003,1,16,18,21,31,9,12,2013-01-07,87,30,3,1,3,1,0,1,21,3,1,1
13004,7,8,12,20,25,3,7,2013-01-09,72,18,2,3,1,1,1,0,10,4,2,1
13005,18,22,26,28,31,10,12,2013-01-12,125,13,1,0,2,3,0,0,22,2,0,1
13006,8,20,25,31,32,5,7,2013-01-14,116,24,2,1,1,3,1,1,12,2,2,1
13007,14,29,32,33,34,3,6,2013-01-16,142,20,2,0,1,4,2,1,9,3,1,0
13008,2,7,25,29,34,3,6,2013-01-19,97,32,3,2,0,3,0,2,9,3,1,0
13009,10,17,19,27,29,5,12,2013-01-21,102,19,4,1,2,2,0,1,17,7,1,1
13010,9,15,17,18,29,9,11,2013-01-23,88,20,4,1,3,1,1,2,20,2,2,1
13011,1,2,8,15,23,6,9,2013-01-26,49,22,3,3,2,0,1,1,15,3,1,1
13012,1,14,31,32,34,2,11,2013-01-28,112,33,2,1,1,3,1,1,13,9,1,1
13013,13,15,29,30,35,1,11,2013-01-30,122,22,4,0,2,3,1,0,12,10,2,1
13014,5,8,25,29,31,2,4,2013-02-02,98,26,4,2,0,3,0,1,6,2,0,0
13015,14,15,26,32,33,1,11,2013-02-04,120,19,2,0,2,3,2,0,12,10,2,1
13016,5,15,19,27,32,8,9,2013-02-06,98,27,4,1,2,2,0,2,17,1,1,1
13017,11,14,22,29,34,5,11,2013-02-16,110,23,2,1,2,2,0,0,16,6,2,1
13018,20,23,31,33,34,3,9,2013-02-18,141,14,3,0,2,3,1,1,12,6,2,1
13019,6,12,17,29,30,7,11,2013-02-20,94,24,2,2,1,2,1,0,18,4,2,1
13020,6,11,20,31,32,5,9,2013-02-23,100,26,2,2,1,2,1,1,14,4,2,1
13021,23,24,28,30,33,1,11,2013-02-25,138,10,2,0,2,3,1,0,12,10,2,1
13022,3,4,13,17,23,3,8,2013-02-27,60,20,4,2,3,0,1,1,11,5,1,1
13023,5,19,24,26,35,5,7,2013-03-02,109,30,3,1,2,2,0,0,12,2,2,1
13024,9,12,14,18,24,1,4,2013-03-04,77,15,1,2,3,0,0,1,5,3,1,0
13025,3,23,25,26,28,10,12,2013-03-06,105,25,3,1,1,3,1,0,22,2,0,1
13026,2,10,16,30,33,5,6,2013-03-09,91,31,1,2,1,2,0,0,11,1,1,0
13027,3,12,14,24,35,3,8,2013-03-11,88,32,2,2,2,1,0,0,11,5,1,1
13028,13,19,28,30,34,8,12,2013-03-13,124,21,2,0,2,3,0,0,20,4,0,1
13029,5,7,17,25,26,4,10,2013-03-16,80,21,4,2,1,2,1,0,14,6,0,1
13030,3,5,9,10,28,5,7,2013-03-18,55,25,3,4,0,1,1,1,12,2,2,1
13031,12,17,18,26,32,10,11,2013-03-20,105,20,1,1,2,2,1,0,21,1,1,1
13032,12,27,28,33,35,1,8,2013-03-23,135,23,3,1,0,4,1,1,9,7,1,1
13033,12,18,22,28,31,1,11,2013-03-25,111,19,1,1,2,2,0,2,12,10,2,1
13034,1,3,11,19,29,4,8,2013-03-27,63,28,5,3,1,1,0,0,12,4,0,1
13035,5,14,28,32,34,7,8,2013-03-30,113,29,1,1,1,3,0,0,15,1,1,1
13036,8,12,32,33,35,3,5,2013-04-01,120,27,2,2,0,3,1,1,8,2,2,0
13037,2,26,31,32,34,6,8,2013-04-03,125,32,1,1,0,4,1,1,14,2,0,1
13038,1,19,24,25,26,7,9,2013-04-06,95,25,3,1,2,2,2,1,16,2,2,1
13039,6,23,30,33,35,7,10,2013-04-08,127,29,3,1,1,3,0,0,17,3,1,1
13040,16,17,22,26,35,3,10,2013-04-10,116,19,2,0,3,2,1,1,13,7,1,1
13041,3,13,14,15,34,5,8,2013-04-13,79,31,3,1,3,1,2,0,13,3,1,1
13042,2,6,22,23,33,1,6,2013-04-15,86,31,2,2,2,1,1,0,7,5,1,0
13043,7,13,25,34,35,7,9,2013-04-17,114,28,4,1,1,3,1,0,16,2,2,1
13044,7,11,13,18,28,5,10,2013-04-20,77,21,3,2,2,1,0,2,15,5,1,1
13045,8,11,12,21,25,2,7,2013-04-22,77,17,3,3,1,1,1,1,9,5,1,1
13046,15,16,19,25,32,5,11,2013-04-24,107,17,3,0,3,2,1,1,16,6,2,1
13047,12,20,28,30,35,3,11,2013-04-27,125,23,1,1,1,3,0,0,14,8,2,1
13048,10,11,23,32,33,1,4,2013-04-29,109,23,3,2,1,2,2,0,5,3,1,0
13049,18,22,25,31,32,4,6,2013-05-01,128,14,2,0,2,3,1,1,10,2,0,0
13050,14,22,30,32,33,7,8,2013-05-04,131,19,1,0,2,3,1,2,15,1,1,1
13051,5,8,15,18,33,7,8,2013-05-06,79,28,3,2,2,1,0,1,15,1,1,1
13052,1,2,10,29,31,1,10,2013-05-08,73,30,3,3,0,2,1,0,11,9,1,1
13053,13,31,33,34,35,5,7,2013-05-11,146,22,4,0,1,4,2,1,12,2,2,1
13054,5,8,21,30,32,1,8,2013-05-13,96,27,2,2,1,2,0,0,9,7,1,1
13055,4,5,22,23,24,3,9,2013-05-15,78,20,2,2,3,0,3,1,12,6,2,1
13056,11,22,30,32,35,3,4,2013-05-18,130,24,2,1,1,3,0,1,7,1,1,0
13057,7,15,27,33,35,7,10,2013-05-20,117,28,5,1,1,3,0,1,17,3,1,1
13058,20,21,27,31,35,7,11,2013-05-22,134,15,4,0,2,3,1,2,18,4,2,1
13059,3,8,11,24,27,7,12,2013-05-25,73,24,3,3,1,1,0,1,19,5,1,1
13060,15,25,26,32,35,5,10,2013-05-27,133,20,3,0,1,4,1,0,15,5,1,1
13061,1,14,18,21,32,5,10,2013-05-29,86,31,2,1,3,1,0,1,15,5,1,1
13062,1,5,8,9,12,9,12,2013-06-01,35,11,3,5,0,0,1,1,21,3,1,1
13063,3,5,11,27,28,5,6,2013-06-03,74,25,4,3,0,2,1,1,11,1,1,0
13064,21,24,26,28,32,1,3,2013-06-05,131,11,1,0,2,3,0,1,4,2,2,0
13065,9,28,31,34,35,2,9,2013-06-08,137,26,3,1,0,4,1,1,11,7,1,1
13066,6,7,13,33,34,2,11,2013-06-10,93,28,3,2,1,2,2,1,13,9,1,1
13067,2,3,5,8,29,10,12,2013-06-12,47,27,3,4,0,1,1,0,22,2,0,1
13068,10,17,27,34,35,5,7,2013-06-15,123,25,3,1,1,3,1,0,12,2,2,1
13069,6,12,13,16,30,7,12,2013-06-17,77,24,1,2,2,1,1,0,19,5,1,1
13070,9,12,18,21,29,1,8,2013-06-19,89,20,3,2,2,1,0,1,9,7,1,1
13071,13,19,26,27,28,3,11,2013-06-22,113,15,3,0,2,3,2,0,14,8,2,1
13072,12,27,28,33,35,3,5,2013-06-24,135,23,3,1,0,4,1,2,8,2,2,0
13073,3,5,23,27,31,2,6,2013-06-26,89,28,5,2,1,2,0,1,8,4,0,0
13074,6,14,20,24,32,1,7,2013-06-29,96,26,0,1,3,1,0,0,8,6,2,1
13075,1,11,13,19,35,7,8,2013-07-01,79,34,5,2,2,1,0,0,15,1,1,1
13076,13,15,16,26,27,9,10,2013-07-03,97,14,3,0,3,2,2,1,19,1,1,1
13077,24,26,30,32,35,6,12,2013-07-06,147,11,1,0,1,4,0,1,18,6,0,1
13078,2,7,23,31,33,2,8,2013-07-08,96,31,4,2,1,2,0,0,10,6,0,1
13079,9,10,17,21,34,1,7,2013-07-10,91,25,3,2,2,1,1,0,8,6,2,1
13080,6,21,23,27,31,4,6,2013-07-13,108,25,4,1,2,2,0,1,10,2,0,0
13081,7,9,15,17,23,2,7,2013-07-15,71,16,5,2,3,0,0,1,9,5,1,1
13082,3,9,25,26,33,3,12,2013-07-17,96,30,4,2,0,3,1,1,15,9,1,1
13083,26,29,30,32,35,4,10,2013-07-20,152,9,2,0,0,5,1,1,14,6,0,1
13084,8,22,26,29,35,1,5,2013-07-22,120,27,2,1,1,3,0,3,6,4,2,0
13085,8,19,23,27,32,3,5,2013-07-24,109,24,3,1,2,2,0,1,8,2,2,0
13086,9,16,26,29,31,6,9,2013-07-27,111,22,3,1,1,3,0,0,15,3,1,1
13087,9,12,22,32,34,2,4,2013-07-29,109,25,1,2,1,2,0,1,6,2,0,0
13088,3,5,8,33,35,1,3,2013-07-31,84,32,4,3,0,2,0,0,4,2,2,0
13089,6,7,23,24,29,4,11,2013-08-03,89,23,3,2,2,1,2,0,15,7,1,1
13090,2,26,30,31,33,11,12,2013-08-05,122,31,2,1,0,4,1,0,23,1,1,1
13091,4,9,28,34,35,2,8,2013-08-07,110,31,2,2,0,3,1,0,10,6,0,1
13092,7,10,21,27,33,3,9,2013-08-10,98,26,4,2,1,2,0,0,12,6,2,1
13093,1,5,17,18,26,5,7,2013-08-12,67,25,3,2,2,1,1,0,12,2,2,1
13094,3,28,33,34,35,6,9,2013-08-14,133,32,3,1,0,4,2,0,15,3,1,1
13095,3,17,28,30,33,1,10,2013-08-17,111,30,3,1,1,3,0,3,11,9,1,1
13096,17,19,20,22,26,6,8,2013-08-19,104,9,2,0,4,1,1,1,14,2,0,1
13097,7,8,13,17,32,3,8,2013-08-21,77,25,3,2,2,1,1,1,11,5,1,1
13098,2,6,16,29,34,10,11,2013-08-24,87,32,1,2,1,2,0,0,21,1,1,1
13099,4,11,28,30,33,5,12,2013-08-26,106,29,2,2,0,3,0,0,17,7,1,1
13100,9,12,24,26,30,5,9,2013-08-28,101,21,1,2,1,2,0,1,14,4,2,1
13101,4,9,13,15,32,2,9,2013-08-31,73,28,3,2,2,1,0,1,11,7,1,1
13102,6,12,15,19,26,2,11,2013-09-02,78,20,2,2,2,1,0,1,13,9,1,1
13103,5,8,13,16,31,3,9,2013-09-04,73,26,3,2,2,1,0,0,12,6,2,1
13104,2,5,11,27,29,1,11,2013-09-07,74,27,4,3,0,2,0,1,12,10,2,1
13105,7,13,27,30,34,1,12,2013-09-09,111,27,3,1,1,3,0,1,13,11,1,1
13106,6,7,12,13,27,3,12,2013-09-11,65,21,3,3,1,1,2,3,15,9,1,1
13107,7,13,14,18,25,5,12,2013-09-14,77,18,3,1,3,1,1,2,17,7,1,1
13108,5,10,13,15,18,2,11,2013-09-16,61,13,3,2,3,0,0,2,13,9,1,1
13109,13,20,26,29,32,2,6,2013-09-18,120,19,2,0,2,3,0,1,8,4,0,0
13110,7,16,18,32,33,2,7,2013-09-21,106,26,2,1,2,2,1,1,9,5,1,1
13111,7,12,13,20,27,1,3,2013-09-23,79,20,3,2,2,1,1,1,4,2,2,0
13112,2,10,20,22,29,5,12,2013-09-25,83,27,1,2,2,1,0,1,17,7,1,1
13113,19,21,23,28,30,8,12,2013-09-28,121,11,3,0,3,2,0,0,20,4,0,1
13114,6,17,21,23,33,1,9,2013-09-30,100,27,4,1,3,1,0,2,10,8,2,1
13115,5,16,29,32,34,4,11,2013-10-02,116,29,2,1,1,3,0,0,15,7,1,1
13116,13,22,23,30,33,9,11,2013-10-05,121,20,3,0,3,2,1,0,20,2,2,1
13117,5,16,23,25,33,7,12,2013-10-07,102,28,4,1,2,2,0,2,19,5,1,1
13118,4,6,11,20,31,1,5,2013-10-09,72,27,2,3,1,1,0,0,6,4,2,0
13119,1,2,16,23,35,1,11,2013-10-12,77,34,3,2,2,1,1,0,12,10,2,1
13120,6,14,15,22,26,3,11,2013-10-14,83,20,1,1,3,1,1,0,14,8,2,1
13121,3,18,19,20,24,3,12,2013-10-16,84,21,2,1,4,0,2,0,15,9,1,1
13122,15,17,20,24,35,4,12,2013-10-19,111,20,3,0,4,1,0,2,16,8,0,1
13123,2,9,10,33,34,5,12,2013-10-21,88,32,2,3,0,2,2,0,17,7,1,1
13124,5,7,18,21,32,10,11,2013-10-23,83,27,3,2,2,1,0,0,21,1,1,1
13125,4,8,14,23,28,4,8,2013-10-26,77,24,1,2,2,1,0,0,12,4,0,1
13126,9,10,15,18,30,3,6,2013-10-28,82,21,2,2,2,1,1,0,9,3,1,0
13127,3,14,16,19,32,5,10,2013-10-30,84,29,2,1,3,1,0,0,15,5,1,1
13128,11,13,27,33,35,1,2,2013-11-02,119,24,5,1,1,3,0,0,3,1,1,0
13129,11,23,29,30,33,1,4,2013-11-04,126,22,4,1,1,3,1,2,5,3,1,0
13130,8,9,15,19,30,6,9,2013-11-06,81,22,3,2,2,1,1,1,15,3,1,1
13131,12,15,29,30,31,4,12,2013-11-09,117,19,3,1,1,3,2,2,16,8,0,1
13132,23,26,28,31,34,2,10,2013-11-11,142,11,2,0,1,4,0,1,12,8,0,1
13133,2,8,10,16,17,9,12,2013-11-13,53,15,1,3,2,0,1,0,21,3,1,1
13134,2,13,19,23,32,2,9,2013-11-16,89,30,3,1,3,1,0,1,11,7,1,1
13135,4,13,19,25,26,7,12,2013-11-18,87,22,3,1,2,2,1,2,19,5,1,1
13136,5,11,15,25,28,5,11,2013-11-20,84,23,4,2,1,2,0,1,16,6,2,1
13137,4,12,32,33,34,6,8,2013-11-23,115,30,1,2,0,3,2,0,14,2,0,1
13138,3,8,13,17,24,7,9,2013-11-25,65,21,3,2,3,0,0,0,16,2,2,1
13139,5,6,18,20,31,6,7,2013-11-27,80,26,2,2,2,1,1,0,13,1,1,1
13140,1,12,17,26,28,1,6,2013-11-30,84,27,2,2,1,2,0,0,7,5,1,0
13141,5,15,18,25,31,8,10,2013-12-02,94,26,4,1,2,2,0,0,18,2,0,1
13142,6,11,25,28,29,4,12,2013-12-04,99,23,3,2,0,3,1,1,16,8,0,1
13143,3,8,14,21,31,6,8,2013-12-07,77,28,3,2,2,1,0,0,14,2,0,1
13144,3,20,21,23,35,2,8,2013-12-09,102,32,4,1,3,1,1,2,10,6,0,1
13145,2,13,15,18,20,2,11,2013-12-11,68,18,2,1,4,0,0,1,13,9,1,1
13146,6,7,15,25,31,1,9,2013-12-14,84,25,4,2,1,2,1,1,10,8,2,1
13147,3,9,22,24,25,5,9,2013-12-16,83,22,3,2,2,1,1,1,14,4,2,1
13148,2,5,9,29,32,3,7,2013-12-18,77,30,3,3,0,2,0,1,10,4,2,1
13149,6,7,8,9,13,5,7,2013-12-21,43,7,3,4,1,0,3,1,12,2,2,1
13150,6,7,14,18,22,8,11,2013-12-23,67,16,1,2,3,0,1,2,19,3,1,1
13151,2,13,21,27,30,3,4,2013-12-25,93,28,3,1,2,2,0,0,7,1,1,0
13152,9,12,14,18,19,3,9,2013-12-28,72,10,2,2,3,0,1,0,12,6,2,1
13153,4,5,16,17,30,3,9,2013-12-30,72,26,2,2,2,1,2,0,12,6,2,1
14001,5,13,20,23,29,8,11,2014-01-01,90,24,4,1,3,1,0,1,19,3,1,1
14002,1,12,21,24,29,1,7,2014-01-04,87,28,3,2,2,1,0,1,8,6,2,1
14003,7,11,13,21,33,5,6,2014-01-06,85,26,5,2,2,1,0,1,11,1,1,0
14004,7,10,19,27,28,9,12,2014-01-08,91,21,3,2,1,2,1,1,21,3,1,1
14005,15,17,18,29,33,4,8,2014-01-11,112,18,4,0,3,2,1,0,12,4,0,1
14006,1,4,7,16,35,6,8,2014-01-13,63,34,3,3,1,1,0,0,14,2,0,1
14007,8,11,14,21,32,3,11,2014-01-15,86,24,2,2,2,1,0,0,14,8,2,1
14008,11,13,20,28,35,1,5,2014-01-18,107,24,3,1,2,2,0,1,6,4,2,0
14009,10,18,25,29,33,7,8,2014-01-20,115,23,3,1,1,3,0,0,15,1,1,1
14010,5,10,20,26,27,1,3,2014-01-22,88,22,2,2,1,2,1,1,4,2,2,0
14011,4,6,14,24,35,7,12,2014-01-25,83,31,1,2,2,1,0,0,19,5,1,1
14012,9,20,21,23,29,5,7,2014-01-27,102,20,4,1,3,1,1,0,12,2,2,1
14013,10,11,13,22,28,4,12,2014-01-29,84,18,2,2,2,1,1,0,16,8,0,1
14014,1,9,11,27,29,3,11,2014-02-08,77,28,5,3,0,2,0,1,14,8,2,1
14015,4,6,18,20,30,5,7,2014-02-10,78,26,0,2,2,1,0,0,12,2,2,1
14016,4,6,13,24,34,4,9,2014-02-12,81,30,1,2,2,1,0,2,13,5,1,1
14017,5,10,11,23,34,1,10,2014-02-15,83,29,3,3,1,1,1,1,11,9,1,1
14018,8,9,12,28,34,2,12,2014-02-17,91,26,1,3,0,2,1,1,14,10,0,1
14019,7,12,22,29,32,11,12,2014-02-19,102,25,2,2,1,2,0,1,23,1,1,1
14020,1,14,17,30,35,6,7,2014-02-22,97,34,3,1,2,2,0,0,13,1,1,1
14021,6,10,17,23,24,3,9,2014-02-24,80,18,2,2,3,0,1,1,12,6,2,1
14022,3,6,10,16,25,10,11,2014-02-26,60,22,2,3,1,1,0,2,21,1,1,1
14023,4,13,15,29,33,5,9,2014-03-01,94,29,4,1,2,2,0,0,14,4,2,1
14024,7,11,15,31,32,6,11,2014-03-03,96,25,4,2,1,2,1,1,17,5,1,1
14025,19,20,27,32,34,6,8,2014-03-05,132,15,2,0,2,3,1,1,14,2,0,1
14026,5,10,12,15,26,4,8,2014-03-08,68,21,2,3,1,1,0,0,12,4,0,1
14027,9,10,24,28,29,10,12,2014-03-10,100,20,2,2,1,2,2,1,22,2,0,1
14028,3,10,20,25,30,10,12,2014-03-12,88,27,2,2,1,2,0,1,22,2,0,1
14029,3,21,22,23,35,5,9,2014-03-15,104,32,4,1,3,1,2,1,14,4,2,1
14030,3,14,18,29,35,11,12,2014-03-17,99,32,3,1,2,2,0,2,23,1,1,1
14031,6,15,27,32,33,3,4,2014-03-19,113,27,3,1,1,3,1,0,7,1,1,0
14032,2,5,6,9,31,2,9,2014-03-22,53,29,3,4,0,1,1,1,11,7,1,1
14033,1,7,8,28,29,4,8,2014-03-24,73,28,3,3,0,2,2,0,12,4,0,1
14034,3,11,14,27,32,5,7,2014-03-26,87,29,3,2,1,2,0,0,12,2,2,1
14035,9,12,14,28,29,3,10,2014-03-29,92,20,2,2,1,2,1,1,13,7,1,1
14036,1,2,12,17,29,3,8,2014-03-31,61,28,3,3,1,1,1,2,11,5,1,1
14037,3,4,8,19,34,2,4,2014-04-02,68,31,2,3,1,1,1,0,6,2,0,0
14038,7,8,12,20,32,3,5,2014-04-05,79,25,1,3,1,1,1,1,8,2,2,0
14039,2,5,11,15,20,8,11,2014-04-07,53,18,3,3,2,0,0,1,19,3,1,1
14040,12,15,21,30,33,2,8,2014-04-09,111,21,3,1,2,2,0,1,10,6,0,1
14041,5,7,11,15,18,5,12,2014-04-12,56,13,4,3,2,0,0,1,17,7,1,1
14042,16,21,25,27,35,6,11,2014-04-14,124,19,4,0,2,3,0,0,17,5,1,1
14043,1,11,23,29,30,1,12,2014-04-16,94,29,4,2,1,2,1,0,13,11,1,1
14044,22,23,25,27,35,3,11,2014-04-19,132,13,4,0,2,3,1,1,14,8,2,1
14045,6,10,12,16,30,2,11,2014-04-21,74,24,0,3,1,1,0,0,13,9,1,1
14046,3,15,18,21,26,1,6,2014-04-23,83,23,3,1,3,1,0,0,7,5,1,0
14047,6,17,18,30,34,6,12,2014-04-26,105,28,1,1,2,2,1,1,18,6,0,1
14048,1,2,5,15,35,1,11,2014-04-28,58,34,4,3,1,1,1,0,12,10,2,1
14049,3,15,17,22,31,3,5,2014-04-30,88,28,4,1,3,1,0,1,8,2,2,0
14050,10,18,27,28,35,1,6,2014-05-03,118,25,2,1,1,3,1,0,7,5,1,0
14051,1,7,11,29,30,3,11,2014-05-05,78,29,4,3,0,2,1,0,14,8,2,1
14052,14,19,21,24,30,2,7,2014-05-07,108,16,2,0,4,1,0,1,9,5,1,1
14053,2,11,17,27,30,3,4,2014-05-10,87,28,3,2,1,2,0,1,7,1,1,0
14054,2,3,20,25,34,1,12,2014-05-12,84,32,2,2,1,2,1,1,13,11,1,1
14055,4,23,26,27,35,10,11,2014-05-14,115,31,3,1,1,3,1,0,21,1,1,1
14056,12,18,28,29,35,7,8,2014-05-17,122,23,2,1,1,3,1,1,15,1,1,1
14057,8,10,20,27,33,1,9,2014-05-19,98,25,2,2,1,2,0,0,10,8,2,1
14058,9,15,22,24,26,2,7,2014-05-21,96,17,2,1,3,1,0,0,9,5,1,1
14059,7,15,17,25,29,4,11,2014-05-24,93,22,5,1,2,2,0,1,15,7,1,1
14060,12,22,29,30,34,5,11,2014-05-26,127,22,1,1,1,3,1,1,16,6,2,1
14061,4,11,17,20,29,6,10,2014-05-28,81,25,3,2,2,1,0,1,16,4,0,1
14062,4,7,17,24,25,2,4,2014-05-31,77,21,3,2,2,1,1,2,6,2,0,0
14063,11,17,21,23,34,3,4,2014-06-02,106,23,4,1,3,1,0,1,7,1,1,0
14064,8,15,33,34,35,1,8,2014-06-04,125,27,3,1,1,3,2,1,9,7,1,1
14065,7,12,19,31,33,7,12,2014-06-07,102,26,4,2,1,2,0,1,19,5,1,1
14066,8,14,16,20,31,3,11,2014-06-09,89,23,1,1,3,1,0,1,14,8,2,1
14067,3,18,23,24,31,3,7,2014-06-11,99,28,3,1,3,1,1,1,10,4,2,1
14068,5,15,24,29,35,5,6,2014-06-14,108,30,4,1,2,2,0,1,11,1,1,0
14069,16,22,27,29,31,2,9,2014-06-16,125,15,3,0,2,3,0,1,11,7,1,1
14070,1,2,7,10,32,4,12,2014-06-18,52,31,2,4,0,1,1,0,16,8,0,1
14071,4,14,15,22,23,1,7,2014-06-21,78,19,2,1,4,0,2,0,8,6,2,1
14072,17,19,22,24,30,2,9,2014-06-23,112,13,2,0,4,1,0,1,11,7,1,1
14073,4,5,7,13,35,5,6,2014-06-25,64,31,4,3,1,1,1,0,11,1,1,0
14074,6,11,22,27,30,5,11,2014-06-28,96,24,2,2,1,2,0,0,16,6,2,1
14075,5,7,29,32,35,4,10,2014-06-30,108,30,4,2,0,3,0,0,14,6,0,1
14076,5,10,19,31,32,9,10,2014-07-02,97,27,3,2,1,2,1,2,19,1,1,1
14077,9,16,26,31,32,1,5,2014-07-05,114,23,2,1,1,3,1,2,6,4,2,0
14078,10,15,16,22,28,4,5,2014-07-07,91,18,1,1,3,1,1,1,9,1,1,0
14079,9,10,20,31,32,6,10,2014-07-09,102,23,2,2,1,2,2,1,16,4,0,1
14080,17,20,23,25,27,3,10,2014-07-12,112,10,4,0,3,2,0,1,13,7,1,1
14081,3,5,8,10,25,9,12,2014-07-14,51,22,3,4,0,1,0,1,21,3,1,1
14082,1,8,18,23,25,8,12,2014-07-16,75,24,3,2,2,1,0,2,20,4,0,1
14083,18,20,24,33,35,5,10,2014-07-19,130,17,2,0,3,2,0,1,15,5,1,1
14084,2,7,9,11,28,5,9,2014-07-21,57,26,3,4,0,1,0,0,14,4,2,1
14085,6,12,13,25,29,11,12,2014-07-23,85,23,3,2,1,2,1,0,23,1,1,1
14086,6,8,27,29,35,3,9,2014-07-26,105,29,3,2,0,3,0,2,12,6,2,1
14087,4,7,31,33,35,9,10,2014-07-28,110,31,4,2,0,3,0,1,19,1,1,1
14088,7,13,20,25,26,8,11,2014-07-30,91,19,3,1,2,2,1,1,19,3,1,1
14089,2,8,12,29,30,7,12,2014-08-02,81,28,1,3,0,2,1,0,19,5,1,1
14090,2,3,20,23,28,6,8,2014-08-04,76,26,2,2,2,1,1,1,14,2,0,1
14091,10,16,18,29,32,2,7,2014-08-06,105,22,1,1,2,2,0,0,9,5,1,1
14092,2,18,27,30,32,5,11,2014-08-09,109,30,1,1,1,3,0,2,16,6,2,1
14093,3,8,30,32,34,9,11,2014-08-11,107,31,1,2,0,3,0,2,20,2,2,1
14094,13,14,24,25,34,4,7,2014-08-13,110,21,2,0,3,2,2,1,11,3,1,1
14095,6,22,30,31,34,5,6,2014-08-16,123,28,1,1,1,3,1,1,11,1,1,0
14096,3,7,21,23,31,5,10,2014-08-18,85,28,5,2,2,1,0,1,15,5,1,1
14097,3,15,20,21,23,7,9,2014-08-20,82,20,4,1,4,0,1,3,16,2,2,1
14098,16,18,22,25,35,3,10,2014-08-23,116,19,2,0,3,2,0,0,13,7,1,1
14099,15,21,22,23,33,1,7,2014-08-25,114,18,4,0,4,1,2,1,8,6,2,1
14100,2,4,8,12,35,1,7,2014-08-27,61,33,1,4,0,1,0,0,8,6,2,1
14101,9,10,12,17,28,3,11,2014-08-30,76,19,2,3,1,1,1,1,14,8,2,1
14102,1,7,14,19,20,3,12,2014-09-01,61,19,3,2,3,0,1,0,15,9,1,1
14103,14,20,23,25,26,10,12,2014-09-03,108,12,2,0,3,2,1,2,22,2,0,1
14104,7,13,14,28,32,4,11,2014-09-06,94,25,2,1,2,2,1,1,15,7,1,1
14105,4,10,26,29,32,4,8,2014-09-08,101,28,1,2,0,3,0,1,12,4,0,1
14106,5,9,11,20,22,5,11,2014-09-10,67,17,3,3,2,0,0,0,16,6,2,1
14107,5,13,14,21,34,8,10,2014-09-13,87,29,3,1,3,1,1,1,18,2,0,1
14108,1,2,13,23,35,9,12,2014-09-15,74,34,4,2,2,1,1,1,21,3,1,1
14109,15,18,20,21,23,1,2,2014-09-17,97,8,3,0,5,0,1,1,3,1,1,0
14110,9,18,19,22,24,8,11,2014-09-20,92,15,2,1,4,0,1,1,19,3,1,1
14111,11,16,18,20,29,3,4,2014-09-22,94,18,2,1,3,1,0,1,7,1,1,0
14112,3,5,14,18,32,2,10,2014-09-24,72,29,2,2,2,1,0,1,12,8,0,1
14113,2,13,17,19,23,1,6,2014-09-27,74,21,4,1,4,0,0,0,7,5,1,0
14114,3,16,24,30,33,5,8,2014-09-29,106,30,2,1,2,2,0,0,13,3,1,1
14115,1,5,26,29,30,2,10,2014-10-01,91,29,3,2,0,3,1,1,12,8,0,1
14116,6,13,15,24,27,4,5,2014-10-04,85,21,3,1,3,1,0,0,9,1,1,0
14117,3,14,17,18,33,6,9,2014-10-06,85,30,3,1,3,1,1,0,15,3,1,1
14118,2,3,23,24,26,5,11,2014-10-08,78,24,2,2,2,1,2,1,16,6,2,1
14119,4,8,9,13,18,8,12,2014-10-11,52,14,2,3,2,0,1,0,20,4,0,1
14120,1,4,6,18,33,5,11,2014-10-13,62,32,2,3,1,1,0,2,16,6,2,1
14121,13,16,18,22,32,8,10,2014-10-15,101,19,1,0,4,1,0,1,18,2,0,1
14122,3,10,25,26,35,1,7,2014-10-18,99,32,3,2,0,3,1,0,8,6,2,1
14123,1,9,12,22,25,2,9,2014-10-20,69,24,3,3,1,1,0,1,11,7,1,1
14124,1,3,28,29,35,8,12,2014-10-22,96,34,4,2,0,3,1,1,20,4,0,1
14125,12,15,19,23,31,4,10,2014-10-25,100,19,4,1,3,1,0,0,14,6,0,1
14126,2,9,22,30,34,9,10,2014-10-27,97,32,1,2,1,2,0,0,19,1,1,1
14127,2,4,6,15,19,2,11,2014-10-29,46,17,2,3,2,0,0,1,13,9,1,1
14128,2,4,16,22,34,8,11,2014-11-01,78,32,0,2,2,1,0,2,19,3,1,1
14129,7,22,28,30,32,5,6,2014-11-03,119,25,1,1,1,3,0,1,11,1,1,0
14130,2,18,31,32,33,5,7,2014-11-05,116,31,2,1,1,3,2,1,12,2,2,1
14131,3,16,19,23,27,3,7,2014-11-08,88,24,4,1,3,1,0,0,10,4,2,1
14132,1,3,4,19,32,1,7,2014-11-10,59,31,3,3,1,1,1,2,8,6,2,1
14133,2,8,12,14,18,4,12,2014-11-12,54,16,0,3,2,0,0,0,16,8,0,1
14134,2,5,7,11,32,9,12,2014-11-15,57,30,3,4,0,1,0,1,21,3,1,1
14135,20,26,28,30,35,9,12,2014-11-17,139,15,1,0,1,4,0,0,21,3,1,1
14136,4,18,20,34,35,7,11,2014-11-19,111,31,1,1,2,2,1,2,18,4,2,1
14137,2,11,16,22,34,2,5,2014-11-22,85,32,1,2,2,1,0,1,7,3,1,0
14138,1,7,29,32,34,9,12,2014-11-24,103,33,3,2,0,3,0,1,21,3,1,1
14139,3,5,7,15,34,1,10,2014-11-26,64,31,4,3,1,1,0,2,11,9,1,1
14140,1,19,20,25,34,7,12,2014-11-29,99,33,3,1,2,2,1,1,19,5,1,1
14141,4,17,20,26,29,5,8,2014-12-01,96,25,2,1,2,2,0,1,13,3,1,1
14142,18,21,25,28,30,4,6,2014-12-03,122,12,2,0,2,3,0,0,10,2,0,0
14143,1,11,14,18,25,6,10,2014-12-06,69,24,3,2,2,1,0,2,16,4,0,1
14144,1,21,24,25,35,4,11,2014-12-08,106,34,4,1,2,2,1,2,15,7,1,1
14145,15,19,22,24,26,10,11,2014-12-10,106,11,2,0,4,1,0,1,21,1,1,1
14146,2,16,23,24,28,10,11,2014-12-13,93,26,1,1,3,1,1,1,21,1,1,1
14147,5,9,14,26,34,2,9,2014-12-15,88,29,2,2,1,2,0,0,11,7,1,1
14148,3,9,10,11,20,7,9,2014-12-17,53,17,3,4,1,0,2,1,16,2,2,1
14149,2,13,19,26,35,1,5,2014-12-20,95,33,3,1,2,2,0,0,6,4,2,0
14150,19,21,30,33,35,5,7,2014-12-22,138,16,4,0,2,3,0,2,12,2,2,1
14151,3,8,26,31,32,8,12,2014-12-24,100,29,2,2,0,3,1,0,20,4,0,1
14152,5,12,18,24,33,1,5,2014-12-27,92,28,2,2,2,1,0,0,6,4,2,0
14153,1,8,13,24,32,5,10,2014-12-29,78,31,2,2,2,1,0,1,15,5,1,1
14154,5,12,17,23,28,2,9,2014-12-31,85,23,3,2,2,1,0,0,11,7,1,1
15001,8,9,19,27,30,6,7,2015-01-03,93,22,3,2,1,2,1,0,13,1,1,1
15002,3,14,20,26,32,6,10,2015-01-05,95,29,1,1,2,2,0,0,16,4,0,1
15003,12,19,27,28,34,1,12,2015-01-07,120,22,2,1,1,3,1,0,13,11,1,1
15004,3,12,14,18,28,5,6,2015-01-10,75,25,1,2,2,1,0,2,11,1,1,0
15005,11,14,15,18,19,7,8,2015-01-12,77,8,3,1,4,0,2,2,15,1,1,1
15006,6,8,30,32,33,3,7,2015-01-14,109,27,1,2,0,3,1,0,10,4,2,1
15007,2,7,8,14,31,4,8,2015-01-17,62,29,2,3,1,1,1,1,12,4,0,1
15008,7,10,11,15,17,3,10,2015-01-19,60,10,4,3,2,0,1,1,13,7,1,1
15009,17,22,26,27,33,6,10,2015-01-21,125,16,3,0,2,3,1,1,16,4,0,1
15010,2,6,17,30,35,2,7,2015-01-24,90,33,2,2,1,2,0,1,9,5,1,1
15011,4,13,22,25,30,1,6,2015-01-26,94,26,2,1,2,2,0,1,7,5,1,0
15012,3,4,6,11,31,5,9,2015-01-28,55,28,3,4,0,1,1,1,14,4,2,1
15013,11,15,25,28,35,7,10,2015-01-31,114,24,4,1,1,3,0,1,17,3,1,1
15014,8,16,25,29,35,3,10,2015-02-02,113,27,3,1,1,3,0,2,13,7,1,1
15015,1,5,13,17,32,4,11,2015-02-04,68,31,4,2,2,1,0,0,15,7,1,1
15016,6,7,16,20,34,9,11,2015-02-07,83,28,1,2,2,1,1,0,20,2,2,1
15017,7,13,16,17,29,1,7,2015-02-09,82,22,4,1,3,1,1,2,8,6,2,1
15018,4,7,10,23,31,3,7,2015-02-11,75,27,3,3,1,1,0,1,10,4,2,1
15019,2,8,16,22,24,1,3,2015-02-14,72,22,0,2,3,0,0,0,4,2,2,0
15020,11,26,28,29,32,1,4,2015-02-16,126,21,2,1,0,4,1,0,5,3,1,0
15021,22,23,24,26,31,5,6,2015-02-25,126,9,2,0,3,2,2,1,11,1,1,0
15022,9,11,14,15,26,11,12,2015-02-28,75,17,3,2,2,1,1,1,23,1,1,1
15023,6,9,11,12,22,3,11,2015-03-02,60,16,2,4,1,0,1,2,14,8,2,1
15024,2,6,8,16,34,3,4,2015-03-04,66,32,0,3,1,1,0,1,7,1,1,0
15025,7,10,20,22,27,10,11,2015-03-07,86,20,2,2,2,1,0,0,21,1,1,1
15026,11,13,14,15,22,2,8,2015-03-09,75,11,3,1,4,0,2,1,10,6,0,1
15027,5,21,22,25,28,3,10,2015-03-11,101,23,3,1,2,2,1,1,13,7,1,1
15028,3,9,28,32,33,9,10,2015-03-14,105,30,3,2,0,3,1,1,19,1,1,1
15029,7,10,19,30,35,3,5,2015-03-16,101,28,3,2,1,2,0,0,8,2,2,0
15030,9,18,19,26,31,2,5,2015-03-18,103,22,3,1,2,2,1,1,7,3,1,0
15031,7,21,29,32,33,4,12,2015-03-21,122,26,4,1,1,3,1,0,16,8,0,1
15032,6,21,25,27,30,7,11,2015-03-23,109,24,3,1,1,3,0,1,18,4,2,1
15033,3,17,22,26,28,3,7,2015-03-25,96,25,2,1,2,2,0,0,10,4,2,1
15034,4,8,15,18,26,5,9,2015-03-28,71,22,1,2,2,1,0,1,14,4,2,1
15035,22,24,29,30,35,1,10,2015-03-30,140,13,2,0,2,3,1,0,11,9,1,1
15036,14,18,20,23,24,4,8,2015-04-01,99,10,1,0,5,0,1,1,12,4,0,1
15037,10,16,21,28,31,7,8,2015-04-04,106,21,2,1,2,2,0,0,15,1,1,1
15038,12,19,22,31,35,7,8,2015-04-06,119,23,3,1,2,2,0,1,15,1,1,1
15039,3,6,7,16,25,1,6,2015-04-08,57,22,3,3,1,1,1,0,7,5,1,0
15040,2,9,10,23,35,9,12,2015-04-11,79,33,3,3,1,1,1,0,21,3,1,1
15041,1,11,21,23,28,1,10,2015-04-13,84,27,4,2,2,1,0,1,11,9,1,1
15042,3,7,12,17,24,2,11,2015-04-15,63,21,3,3,2,0,0,0,13,9,1,1
15043,2,20,22,25,29,2,7,2015-04-18,98,27,2,1,2,2,0,0,9,5,1,1
15044,16,18,27,31,33,1,3,2015-04-20,125,17,3,0,2,3,0,0,4,2,2,0
15045,8,9,22,29,30,8,12,2015-04-22,98,22,2,2,1,2,2,0,20,4,0,1
15046,5,7,10,22,26,4,10,2015-04-25,70,21,2,3,1,1,0,1,14,6,0,1
15047,1,2,17,23,31,5,12,2015-04-27,74,30,4,2,2,1,1,0,17,7,1,1
15048,10,11,22,24,33,2,9,2015-04-29,100,23,2,2,2,1,1,0,11,7,1,1
15049,8,9,11,15,22,8,10,2015-05-02,65,14,3,3,2,0,1,2,18,2,0,1
15050,6,7,10,20,28,2,7,2015-05-04,71,22,1,3,1,1,1,0,9,5,1,1
15051,1,2,11,16,21,1,5,2015-05-06,51,20,3,3,2,0,1,0,6,4,2,0
15052,13,19,24,27,29,7,8,2015-05-09,112,16,4,0,3,2,0,0,15,1,1,1
15053,8,25,28,29,32,4,7,2015-05-11,122,24,2,1,0,4,1,1,11,3,1,1
15054,2,9,15,24,34,3,9,2015-05-13,84,32,2,2,2,1,0,0,12,6,2,1
15055,6,11,14,20,30,5,10,2015-05-16,81,24,1,2,2,1,0,0,15,5,1,1
15056,6,12,19,26,35,3,10,2015-05-18,98,29,2,2,1,2,0,1,13,7,1,1
15057,1,5,7,14,26,4,6,2015-05-20,53,25,3,3,1,1,0,1,10,2,0,0
15058,10,14,20,27,30,7,12,2015-05-23,101,20,1,1,2,2,0,1,19,5,1,1
15059,7,9,19,23,32,1,3,2015-05-25,90,25,4,2,2,1,0,0,4,2,2,0
15060,16,24,25,26,33,4,11,2015-05-27,124,17,2,0,2,3,2,0,15,7,1,1
15061,6,7,8,16,22,2,10,2015-05-30,59,16,1,3,2,0,2,1,12,8,0,1
15062,6,7,13,14,15,1,4,2015-06-01,55,9,3,2,3,0,3,2,5,3,1,0
15063,1,4,6,34,35,2,4,2015-06-03,80,34,2,3,0,2,1,1,6,2,0,0
15064,2,8,20,28,31,7,10,2015-06-06,89,29,1,2,1,2,0,0,17,3,1,1
15065,4,5,7,13,35,8,11,2015-06-08,64,31,4,3,1,1,1,0,19,3,1,1
15066,1,3,7,13,29,2,10,2015-06-10,53,28,5,3,1,1,0,2,12,8,0,1
15067,4,10,18,24,27,4,11,2015-06-13,83,23,1,2,2,1,0,0,15,7,1,1
15068,2,3,20,31,35,4,8,2015-06-15,91,33,3,2,1,2,1,0,12,4,0,1
15069,2,9,11,22,25,1,7,2015-06-17,69,23,3,3,1,1,0,1,8,6,2,1
15070,3,9,12,17,18,4,12,2015-06-20,59,15,3,3,2,0,1,1,16,8,0,1
15071,4,6,13,16,34,4,10,2015-06-22,73,30,1,2,2,1,0,0,14,6,0,1
15072,19,20,21,31,33,9,10,2015-06-24,124,14,4,0,3,2,2,0,19,1,1,1
15073,9,26,27,30,34,1,6,2015-06-27,126,25,2,1,0,4,1,0,7,5,1,0
15074,1,12,21,27,33,4,9,2015-06-29,94,32,4,2,1,2,0,1,13,5,1,1
15075,13,14,26,27,33,10,12,2015-07-01,113,20,3,0,2,3,2,2,22,2,0,1
15076,3,19,21,31,34,5,12,2015-07-04,108,31,4,1,2,2,0,0,17,7,1,1
15077,1,16,17,22,28,2,9,2015-07-06,84,27,2,1,3,1,1,0,11,7,1,1
15078,19,24,26,28,33,1,2,2015-07-08,130,14,2,0,2,3,0,1,3,1,1,0
15079,1,9,17,23,24,4,5,2015-07-11,74,23,4,2,3,0,1,1,9,1,1,0
15080,14,20,29,30,32,3,8,2015-07-13,125,18,1,0,2,3,1,0,11,5,1,1
15081,3,4,10,13,17,5,9,2015-07-15,47,14,3,3,2,0,1,0,14,4,2,1
15082,8,15,28,31,33,3,6,2015-07-18,115,25,3,1,1,3,0,0,9,3,1,0
15083,14,16,19,25,29,10,12,2015-07-20,103,15,3,0,3,2,0,0,22,2,0,1
15084,10,20,21,32,34,6,7,2015-07-22,117,24,1,1,2,2,1,0,13,1,1,1
15085,2,3,4,6,16,3,12,2015-07-25,31,14,1,4,1,0,2,0,15,9,1,1
15086,5,9,11,15,32,4,9,2015-07-27,72,27,4,3,1,1,0,0,13,5,1,1
15087,2,5,15,17,22,1,11,2015-07-29,61,20,3,2,3,0,0,2,12,10,2,1
15088,5,15,28,31,34,11,12,2015-08-01,113,29,3,1,1,3,0,2,23,1,1,1
15089,5,12,18,20,27,10,12,2015-08-03,82,22,2,2,2,1,0,1,22,2,0,1
15090,6,9,11,17,21,6,8,2015-08-05,64,15,4,3,2,0,0,0,14,2,0,1
15091,2,7,28,29,30,3,7,2015-08-08,96,28,2,2,0,3,2,0,10,4,2,1
15092,2,14,21,27,34,5,8,2015-08-10,98,32,2,1,2,2,0,1,13,3,1,1
15093,16,17,25,26,27,2,4,2015-08-12,111,11,3,0,2,3,3,1,6,2,0,0
15094,2,3,10,11,29,3,7,2015-08-15,55,27,3,4,0,1,2,0,10,4,2,1
15095,8,14,26,34,35,5,10,2015-08-17,117,27,1,1,1,3,1,0,15,5,1,1
15096,3,9,12,18,21,2,6,2015-08-19,63,18,3,3,2,0,0,0,8,4,0,0
15097,4,16,17,26,27,1,4,2015-08-22,90,23,2,1,2,2,2,0,5,3,1,0
15098,9,14,21,27,33,6,9,2015-08-24,104,24,4,1,2,2,0,1,15,3,1,1
15099,9,12,14,22,25,5,10,2015-08-26,82,16,2,2,2,1,0,2,15,5,1,1
15100,9,15,18,23,32,5,7,2015-08-29,97,23,3,1,3,1,0,1,12,2,2,1
15101,6,12,17,18,32,7,12,2015-08-31,85,26,1,2,2,1,1,2,19,5,1,1
15102,11,14,15,33,34,3,12,2015-09-02,107,23,3,1,2,2,2,0,15,9,1,1
15103,7,9,15,25,34,4,10,2015-09-05,90,27,4,2,1,2,0,2,14,6,0,1
15104,16,19,25,30,34,4,9,2015-09-07,124,18,2,0,2,3,0,2,13,5,1,1
15105,8,9,15,21,27,5,9,2015-09-09,80,19,4,2,2,1,1,0,14,4,2,1
15106,2,11,13,22,30,2,3,2015-09-12,78,28,2,2,2,1,0,0,5,1,1,0
15107,3,23,25,28,29,6,7,2015-09-14,108,26,4,1,1,3,1,0,13,1,1,1
15108,1,13,16,26,31,7,12,2015-09-16,87,30,3,1,2,2,0,0,19,5,1,1
15109,1,6,11,22,31,3,12,2015-09-19,71,30,3,3,1,1,0,2,15,9,1,1
15110,2,7,10,22,30,7,11,2015-09-21,71,28,1,3,1,1,0,1,18,4,2,1
15111,7,8,16,24,28,3,10,2015-09-23,83,21,1,2,2,1,1,1,13,7,1,1
15112,4,5,15,19,28,4,11,2015-09-26,71,24,3,2,2,1,1,1,15,7,1,1
15113,1,14,21,29,33,2,10,2015-09-28,98,32,4,1,2,2,0,0,12,8,0,1
15114,9,18,24,31,34,2,10,2015-09-30,116,25,2,1,2,2,0,0,12,8,0,1
15115,8,12,13,14,16,3,9,2015-10-03,63,8,1,2,3,0,2,0,12,6,2,1
15116,7,10,19,24,33,3,7,2015-10-05,93,26,3,2,2,1,0,0,10,4,2,1
15117,6,17,20,30,33,10,11,2015-10-07,106,27,2,1,2,2,0,1,21,1,1,1
15118,3,7,20,24,31,4,9,2015-10-10,85,28,3,2,2,1,0,1,13,5,1,1
15119,1,8,12,16,21,6,11,2015-10-12,58,20,2,3,2,0,0,0,17,5,1,1
15120,1,9,15,24,32,5,10,2015-10-14,81,31,3,2,2,1,0,1,15,5,1,1
15121,2,4,17,27,28,4,6,2015-10-17,78,26,2,2,1,2,1,0,10,2,0,0
15122,11,13,15,26,35,6,11,2015-10-19,100,24,4,1,2,2,0,0,17,5,1,1
15123,4,15,27,29,30,2,10,2015-10-21,105,26,3,1,1,3,1,1,12,8,0,1
15124,4,6,12,31,32,3,6,2015-10-24,85,28,1,3,0,2,1,1,9,3,1,0
15125,2,3,15,17,28,8,10,2015-10-26,65,26,3,2,2,1,1,0,18,2,0,1
15126,4,5,8,9,21,3,6,2015-10-28,47,17,3,4,1,0,2,0,9,3,1,0
15127,9,11,14,19,30,3,8,2015-10-31,83,21,3,2,2,1,0,1,11,5,1,1
15128,10,12,23,30,32,3,4,2015-11-02,107,22,1,2,1,2,0,1,7,1,1,0
15129,1,6,23,25,29,3,9,2015-11-04,84,28,4,2,1,2,0,1,12,6,2,1
15130,17,25,31,32,34,2,12,2015-11-07,139,17,3,0,1,4,1,1,14,10,0,1
15131,11,17,19,20,27,2,3,2015-11-09,94,16,4,1,3,1,1,1,5,1,1,0
15132,3,8,14,18,27,1,5,2015-11-11,70,24,2,2,2,1,0,1,6,4,2,0
15133,3,7,8,25,30,4,8,2015-11-14,73,27,3,3,0,2,1,2,12,4,0,1
15134,1,2,6,15,35,4,7,2015-11-16,59,34,3,3,1,1,1,0,11,3,1,1
15135,5,16,20,25,29,6,8,2015-11-18,95,24,3,1,2,2,0,0,14,2,0,1
15136,5,20,23,29,32,2,10,2015-11-21,109,27,3,1,2,2,0,3,12,8,0,1
15137,14,17,21,23,26,8,11,2015-11-23,101,12,3,0,4,1,0,1,19,3,1,1
15138,1,16,20,29,32,4,7,2015-11-25,98,31,2,1,2,2,0,0,11,3,1,1
15139,2,3,5,25,32,5,7,2015-11-28,67,30,3,3,0,2,1,1,12,2,2,1
15140,1,11,15,26,35,6,11,2015-11-30,88,34,4,2,1,2,0,0,17,5,1,1
15141,2,4,15,19,31,2,3,2015-12-02,71,29,3,2,2,1,0,1,5,1,1,0
15142,12,14,22,26,30,3,6,2015-12-05,104,18,0,1,2,2,0,0,9,3,1,0
15143,9,20,31,33,35,10,11,2015-12-07,128,26,4,1,1,3,0,0,21,1,1,1
15144,1,9,24,26,29,6,11,2015-12-09,89,28,3,2,1,2,0,1,17,5,1,1
15145,6,7,20,29,32,11,12,2015-12-12,94,26,2,2,1,2,1,1,23,1,1,1
15146,4,15,19,27,31,4,11,2015-12-14,96,27,4,1,2,2,0,0,15,7,1,1
15147,1,2,13,18,19,8,10,2015-12-16,53,18,3,2,3,0,2,1,18,2,0,1
15148,8,11,27,31,33,8,9,2015-12-19,110,25,4,2,0,3,0,0,17,1,1,1
15149,4,6,10,12,28,2,8,2015-12-21,60,24,0,4,0,1,0,0,10,6,0,1
15150,4,13,18,25,33,3,7,2015-12-23,93,29,3,1,2,2,0,1,10,4,2,1
15151,15,16,18,30,35,1,7,2015-12-26,114,20,2,0,3,2,1,1,8,6,2,1
15152,4,5,22,29,35,2,11,2015-12-28,95,31,3,2,1,2,1,1,13,9,1,1
15153,1,7,22,27,33,2,11,2015-12-30,90,32,4,2,1,2,0,1,13,9,1,1
16001,1,7,19,20,30,5,10,2016-01-02,77,29,3,2,2,1,1,2,15,5,1,1
16002,7,12,18,25,35,7,9,2016-01-04,97,28,3,2,1,2,0,1,16,2,2,1
16003,4,12,17,22,26,6,7,2016-01-06,81,22,1,2,2,1,0,1,13,1,1,1
16004,10,20,23,32,35,9,10,2016-01-09,120,25,2,1,2,2,0,0,19,1,1,1
16005,6,9,12,15,20,8,11,2016-01-11,62,14,2,3,2,0,0,1,19,3,1,1
16006,14,16,17,22,24,2,9,2016-01-13,93,10,1,0,5,0,1,0,11,7,1,1
16007,2,5,14,32,35,1,3,2016-01-16,88,33,2,2,1,2,0,1,4,2,2,0
16008,5,12,31,34,35,4,5,2016-01-18,117,30,3,2,0,3,1,2,9,1,1,0
16009,5,8,10,17,20,2,12,2016-01-20,60,15,2,3,2,0,0,1,14,10,0,1
16010,12,13,15,16,28,2,5,2016-01-23,84,16,2,1,3,1,2,0,7,3,1,0
16011,2,8,10,15,23,5,10,2016-01-25,58,21,2,3,2,0,0,1,15,5,1,1
16012,5,7,11,23,28,3,12,2016-01-27,74,23,4,3,1,1,0,1,15,9,1,1
16013,3,21,23,31,35,2,11,2016-01-30,113,32,5,1,2,2,0,1,13,9,1,1
16014,6,8,21,24,27,2,10,2016-02-01,86,21,2,2,2,1,0,1,12,8,0,1
16015,1,4,10,13,30,3,9,2016-02-03,58,29,2,3,1,1,0,0,12,6,2,1
16016,3,10,22,29,32,2,5,2016-02-06,96,29,2,2,1,2,0,1,7,3,1,0
16017,11,18,24,28,29,5,10,2016-02-15,110,18,2,1,2,2,1,1,15,5,1,1
16018,5,10,13,27,33,8,11,2016-02-17,88,28,4,2,1,2,0,0,19,3,1,1
16019,4,11,15,20,26,8,9,2016-02-20,76,22,2,2,2,1,0,0,17,1,1,1
16020,1,16,22,29,30,2,9,2016-02-22,98,29,2,1,2,2,1,0,11,7,1,1
16021,1,4,9,10,35,9,11,2016-02-24,59,34,3,4,0,1,1,1,20,2,2,1
16022,4,18,21,30,35,2,11,2016-02-27,108,31,2,1,2,2,0,2,13,9,1,1
16023,4,9,14,25,27,6,11,2016-02-29,79,23,3,2,1,2,0,1,17,5,1,1
16024,1,2,11,15,18,4,8,2016-03-02,47,17,3,3,2,0,1,0,12,4,0,1
16025,3,6,13,23,24,7,10,2016-03-05,69,21,3,2,3,0,1,0,17,3,1,1
16026,2,6,29,30,34,1,7,2016-03-07,101,32,1,2,0,3,1,1,8,6,2,1
16027,6,11,13,15,28,2,6,2016-03-09,73,22,3,2,2,1,0,1,8,4,0,0
16028,13,18,20,23,31,3,6,2016-03-12,105,18,3,0,4,1,0,1,9,3,1,0
16029,20,26,27,29,32,5,12,2016-03-14,134,12,2,0,1,4,1,1,17,7,1,1
16030,10,19,21,29,33,4,6,2016-03-16,112,23,4,1,2,2,0,1,10,2,0,0
16031,3,14,24,27,29,4,11,2016-03-19,97,26,3,1,2,2,0,1,15,7,1,1
16032,5,9,14,20,33,5,12,2016-03-21,81,28,3,2,2,1,0,1,17,7,1,1
16033,3,14,15,31,35,9,10,2016-03-23,98,32,4,1,2,2,1,1,19,1,1,1
16034,14,18,31,32,35,9,10,2016-03-26,130,21,2,0,2,3,1,3,19,1,1,1
16035,17,22,24,25,29,9,12,2016-03-28,117,12,3,0,3,2,1,0,21,3,1,1
16036,7,15,26,30,31,3,6,2016-03-30,109,24,3,1,1,3,1,0,9,3,1,0
16037,3,5,13,24,34,3,5,2016-04-02,79,31,3,2,2,1,0,0,8,2,2,0
16038,3,7,9,15,33,5,12,2016-04-04,67,30,5,3,1,1,0,1,17,7,1,1
16039,1,8,16,22,28,4,5,2016-04-06,75,27,1,2,2,1,0,0,9,1,1,0
16040,20,22,29,30,35,1,6,2016-04-09,136,15,2,0,2,3,1,1,7,5,1,0
16041,12,23,24,27,34,3,6,2016-04-11,120,22,2,1,2,2,1,0,9,3,1,0
16042,2,6,8,19,24,1,6,2016-04-13,59,22,1,3,2,0,0,1,7,5,1,0
16043,1,9,16,33,34,9,12,2016-04-16,93,33,3,2,1,2,1,0,21,3,1,1
16044,1,6,10,20,31,5,11,2016-04-18,68,30,2,3,1,1,0,1,16,6,2,1
16045,7,11,25,30,33,2,8,2016-04-20,106,26,4,2,0,3,0,0,10,6,0,1
16046,3,19,22,32,34,8,12,2016-04-23,110,31,2,1,2,2,0,0,20,4,0,1
16047,2,3,23,29,32,5,9,2016-04-25,89,30,3,2,1,2,1,2,14,4,2,1
16048,4,12,17,25,27,4,10,2016-04-27,85,23,3,2,1,2,0,0,14,6,0,1
16049,3,4,5,27,33,4,9,2016-04-30,72,30,4,3,0,2,2,2,13,5,1,1
16050,7,17,21,29,35,4,5,2016-05-02,109,28,5,1,2,2,0,0,9,1,1,0
16051,16,21,23,24,32,7,8,2016-05-04,116,16,2,0,4,1,1,1,15,1,1,1
16052,8,14,19,20,33,10,11,2016-05-07,94,25,2,1,3,1,1,0,21,1,1,1
16053,4,13,15,30,35,3,5,2016-05-09,97,31,3,1,2,2,0,0,8,2,2,0
16054,2,5,9,21,30,6,7,2016-05-11,67,28,3,3,1,1,0,1,13,1,1,1
16055,6,21,27,30,34,4,9,2016-05-14,118,28,2,1,1,3,0,2,13,5,1,1
16056,10,12,14,31,35,4,5,2016-05-16,102,25,2,2,1,2,0,0,9,1,1,0
16057,8,17,19,23,30,3,8,2016-05-18,97,22,3,1,3,1,0,0,11,5,1,1
16058,2,15,17,23,28,5,9,2016-05-21,85,26,3,1,3,1,0,2,14,4,2,1
16059,2,10,27,28,33,5,7,2016-05-23,100,31,2,2,0,3,1,2,12,2,2,1
16060,2,6,22,27,34,8,11,2016-05-25,91,32,1,2,1,2,0,2,19,3,1,1
16061,9,15,17,21,23,7,12,2016-05-28,85,14,5,1,4,0,0,0,19,5,1,1
16062,2,10,14,15,35,1,9,2016-05-30,76,33,2,2,2,1,1,1,10,8,2,1
16063,8,12,22,27,35,5,9,2016-06-01,104,27,2,2,1,2,0,1,14,4,2,1
16064,1,2,10,18,35,5,11,2016-06-04,66,34,2,3,1,1,1,1,16,6,2,1
16065,1,9,18,22,24,11,12,2016-06-06,74,23,2,2,3,0,0,2,23,1,1,1
16066,10,28,29,31,33,5,11,2016-06-08,131,23,3,1,0,4,1,0,16,6,2,1
16067,2,8,11,13,19,2,8,2016-06-11,53,17,3,3,2,0,0,0,10,6,0,1
16068,5,7,22,26,34,7,12,2016-06-13,94,29,2,2,1,2,0,0,19,5,1,1
16069,14,17,19,23,30,2,9,2016-06-15,103,16,3,0,4,1,0,0,11,7,1,1
16070,2,9,13,19,23,5,7,2016-06-18,66,21,4,2,3,0,0,2,12,2,2,1
16071,8,15,19,20,33,7,12,2016-06-20,95,25,3,1,3,1,1,1,19,5,1,1
16072,16,20,24,26,31,4,9,2016-06-22,117,15,1,0,3,2,0,1,13,5,1,1
16073,7,14,17,24,27,8,10,2016-06-25,89,20,3,1,3,1,0,1,18,2,0,1
16074,1,5,7,11,14,3,8,2016-06-27,38,13,4,4,1,0,0,2,11,5,1,1
16075,3,7,17,22,31,8,12,2016-06-29,80,28,4,2,2,1,0,1,20,4,0,1
16076,3,8,10,17,31,5,6,2016-07-02,69,28,3,3,1,1,0,3,11,1,1,0
16077,9,11,14,16,35,2,5,2016-07-04,85,26,3,2,2,1,0,0,7,3,1,0
16078,7,18,29,31,35,5,11,2016-07-06,120,28,4,1,1,3,0,1,16,6,2,1
16079,7,14,15,20,27,5,10,2016-07-09,83,20,3,1,3,1,1,1,15,5,1,1
16080,15,20,29,30,33,7,12,2016-07-11,127,18,3,0,2,3,1,2,19,5,1,1
16081,6,7,18,21,33,3,8,2016-07-13,85,27,3,2,2,1,1,1,11,5,1,1
16082,3,8,23,28,29,2,7,2016-07-16,91,26,3,2,1,2,1,0,9,5,1,1
16083,1,5,9,33,35,1,5,2016-07-18,83,34,5,3,0,2,0,0,6,4,2,0
16084,8,12,15,26,35,1,8,2016-07-20,96,27,2,2,1,2,0,1,9,7,1,1
16085,14,15,27,31,32,1,7,2016-07-23,119,18,3,0,2,3,2,1,8,6,2,1
16086,3,5,22,25,30,7,9,2016-07-25,85,27,3,2,1,2,0,0,16,2,2,1
16087,3,16,17,23,25,7,9,2016-07-27,84,22,4,1,3,1,1,2,16,2,2,1
16088,4,6,17,21,30,6,11,2016-07-30,78,26,2,2,2,1,0,1,17,5,1,1
16089,7,14,17,28,34,7,10,2016-08-01,100,27,2,1,2,2,0,1,17,3,1,1
16090,4,6,8,28,32,7,12,2016-08-03,78,28,0,3,0,2,0,1,19,5,1,1
16091,8,13,17,21,22,2,8,2016-08-06,81,14,3,1,4,0,1,1,10,6,0,1
16092,2,13,31,33,34,7,11,2016-08-08,113,32,3,1,1,3,1,1,18,4,2,1
16093,1,8,14,30,35,6,7,2016-08-10,88,34,2,2,1,2,0,0,13,1,1,1
16094,1,14,16,17,18,5,7,2016-08-13,66,17,2,1,4,0,2,2,12,2,2,1
16095,8,12,18,19,21,3,6,2016-08-15,78,13,2,2,3,0,1,1,9,3,1,0
16096,1,6,8,12,21,5,10,2016-08-17,48,20,2,4,1,0,0,3,15,5,1,1
16097,6,8,18,31,33,10,12,2016-08-20,96,27,2,2,1,2,0,2,22,2,0,1
16098,8,9,11,20,29,4,5,2016-08-22,77,21,3,3,1,1,1,1,9,1,1,0
16099,3,4,12,14,27,1,5,2016-08-24,60,24,2,3,1,1,1,0,6,4,2,0
16100,8,12,19,26,30,2,12,2016-08-27,95,22,1,2,1,2,0,1,14,10,0,1
16101,4,6,28,33,35,7,12,2016-08-29,106,31,2,2,0,3,0,0,19,5,1,1
16102,3,5,6,34,35,3,12,2016-08-31,83,32,3,3,0,2,2,2,15,9,1,1
16103,5,14,20,23,29,3,11,2016-09-03,91,24,3,1,3,1,0,1,14,8,2,1
16104,1,20,22,23,30,6,7,2016-09-05,96,29,2,1,3,1,1,2,13,1,1,1
16105,8,11,31,34,35,1,2,2016-09-07,119,27,3,2,0,3,1,0,3,1,1,0
16106,3,21,30,33,35,1,4,2016-09-10,122,32,4,1,1,3,0,1,5,3,1,0
16107,2,6,19,24,26,4,6,2016-09-12,77,24,1,2,2,1,0,0,10,2,0,0
16108,10,17,22,23,25,7,9,2016-09-14,97,15,3,1,3,1,1,0,16,2,2,1
16109,3,25,28,31,34,11,12,2016-09-17,121,31,3,1,0,4,0,1,23,1,1,1
16110,7,20,21,23,30,7,10,2016-09-19,101,23,3,1,3,1,1,0,17,3,1,1
16111,4,9,22,26,27,2,12,2016-09-21,88,23,2,2,1,2,1,0,14,10,0,1
16112,7,22,23,31,32,4,5,2016-09-24,115,25,3,1,2,2,2,1,9,1,1,0
16113,10,11,17,30,34,3,12,2016-09-26,102,24,2,2,1,2,1,0,15,9,1,1
16114,16,17,20,32,33,3,7,2016-09-28,118,17,2,0,3,2,2,1,10,4,2,1
16115,1,4,15,31,34,2,11,2016-10-01,85,33,3,2,1,2,0,0,13,9,1,1
16116,4,6,8,19,34,10,12,2016-10-03,71,30,1,3,1,1,0,2,22,2,0,1
16117,3,9,14,16,23,2,9,2016-10-05,65,20,3,2,3,0,0,0,11,7,1,1
16118,12,15,18,24,29,3,11,2016-10-08,98,17,2,1,3,1,0,0,14,8,2,1
16119,2,3,9,21,22,5,10,2016-10-10,57,20,3,3,2,0,2,0,15,5,1,1
16120,3,10,20,32,34,4,7,2016-10-12,99,31,1,2,1,2,0,1,11,3,1,1
16121,4,5,8,15,20,1,6,2016-10-15,52,16,2,3,2,0,1,1,7,5,1,0
16122,1,3,12,14,29,2,6,2016-10-17,59,28,3,3,1,1,0,0,8,4,0,0
16123,4,5,13,20,32,1,10,2016-10-19,74,28,2,2,2,1,1,0,11,9,1,1
16124,4,13,24,26,29,8,11,2016-10-22,96,25,2,1,2,2,0,2,19,3,1,1
16125,6,7,8,28,30,1,2,2016-10-24,79,24,1,3,0,2,2,0,3,1,1,0
16126,11,13,16,19,24,6,8,2016-10-26,83,13,3,1,4,0,0,0,14,2,0,1
16127,1,5,15,24,26,9,10,2016-10-29,71,25,3,2,2,1,0,1,19,1,1,1
16128,17,20,22,30,33,7,8,2016-10-31,122,16,2,0,3,2,0,0,15,1,1,1
16129,7,8,19,30,35,8,9,2016-11-02,99,28,3,2,1,2,1,1,17,1,1,1
16130,11,23,32,33,34,1,12,2016-11-05,133,23,3,1,1,3,2,0,13,11,1,1
16131,6,13,25,28,30,2,7,2016-11-07,102,24,2,1,1,3,0,0,9,5,1,1
16132,4,18,19,22,35,1,2,2016-11-09,98,31,2,1,3,1,1,0,3,1,1,0
16133,1,4,5,23,28,5,9,2016-11-12,61,27,3,3,1,1,1,1,14,4,2,1
16134,1,3,31,32,34,2,7,2016-11-14,101,33,3,2,0,3,1,1,9,5,1,1
16135,1,10,12,18,35,1,12,2016-11-16,76,34,2,3,1,1,0,1,13,11,1,1
16136,5,6,7,19,23,4,11,2016-11-19,60,18,4,3,2,0,2,0,15,7,1,1
16137,7,20,23,29,34,2,10,2016-11-21,113,27,3,1,2,2,0,2,12,8,0,1
16138,12,13,16,29,35,5,11,2016-11-23,105,23,3,1,2,2,1,1,16,6,2,1
16139,13,21,30,31,35,1,8,2016-11-26,130,22,4,0,2,3,1,2,9,7,1,1
16140,12,16,23,29,34,4,11,2016-11-28,114,22,2,1,2,2,0,0,15,7,1,1
16141,2,6,7,19,28,11,12,2016-11-30,62,26,2,3,1,1,1,0,23,1,1,1
16142,1,6,17,23,26,6,12,2016-12-03,73,25,3,2,2,1,0,1,18,6,0,1
16143,4,6,22,27,31,6,7,2016-12-05,90,27,2,2,1,2,0,1,13,1,1,1
16144,4,5,13,22,31,5,10,2016-12-07,75,27,3,2,2,1,1,3,15,5,1,1
16145,1,9,11,17,28,3,8,2016-12-10,66,27,4,3,1,1,0,0,11,5,1,1
16146,21,22,25,29,34,1,11,2016-12-12,131,13,3,0,2,3,1,0,12,10,2,1
16147,7,19,20,28,30,4,12,2016-12-14,104,23,2,1,2,2,1,0,16,8,0,1
16148,5,14,15,23,25,6,8,2016-12-17,82,20,4,1,3,1,1,0,14,2,0,1
16149,1,2,3,12,33,4,9,2016-12-19,51,32,3,4,0,1,2,0,13,5,1,1
16150,1,10,18,24,29,7,10,2016-12-21,82,28,2,2,2,1,0,1,17,3,1,1
16151,4,7,11,14,21,5,12,2016-12-24,57,17,3,3,2,0,0,0,17,7,1,1
16152,8,17,22,24,30,5,11,2016-12-26,101,22,1,1,3,1,0,0,16,6,2,1
16153,13,18,25,29,35,3,11,2016-12-28,120,22,4,0,2,3,0,0,14,8,2,1
16154,6,16,17,21,29,4,6,2016-12-31,89,23,3,1,3,1,1,1,10,2,0,0
17001,7,9,20,31,33,8,10,2017-01-02,100,26,4,2,1,2,0,0,18,2,0,1
17002,7,12,14,31,34,9,11,2017-01-04,98,27,2,2,1,2,0,2,20,2,2,1
17003,3,5,6,13,22,9,12,2017-01-07,49,19,3,3,2,0,1,0,21,3,1,1
17004,5,8,11,28,31,6,7,2017-01-09,83,26,3,3,0,2,0,1,13,1,1,1
17005,5,9,20,26,35,2,11,2017-01-11,95,30,3,2,1,2,0,1,13,9,1,1
17006,4,6,23,32,33,5,6,2017-01-14,98,29,2,2,1,2,1,0,11,1,1,0
17007,8,11,17,25,27,2,4,2017-01-16,88,19,4,2,1,2,0,0,6,2,0,0
17008,3,4,9,25,32,2,4,2017-01-18,73,29,3,3,0,2,1,1,6,2,0,0
17009,5,6,8,12,22,3,4,2017-01-21,53,17,1,4,1,0,1,0,7,1,1,0
17010,4,10,13,18,35,1,2,2017-01-23,80,31,2,2,2,1,0,0,3,1,1,0
17011,5,15,21,29,34,6,9,2017-01-25,104,29,4,1,2,2,0,0,15,3,1,1
17012,4,5,24,26,35,7,12,2017-02-04,94,31,2,2,1,2,1,1,19,5,1,1
17013,5,12,17,30,34,11,12,2017-02-06,98,29,2,2,1,2,0,1,23,1,1,1
17014,4,8,15,24,25,2,5,2017-02-08,76,21,2,2,2,1,1,0,7,3,1,0
17015,1,7,19,27,34,1,2,2017-02-11,88,33,4,2,1,2,0,0,3,1,1,0
17016,3,13,28,30,33,9,10,2017-02-13,107,30,3,1,1,3,0,0,19,1,1,1
17017,4,19,24,26,29,4,6,2017-02-15,102,25,2,1,2,2,0,0,10,2,0,0
17018,6,7,10,17,23,1,9,2017-02-18,63,17,3,3,2,0,1,0,10,8,2,1
17019,2,6,14,23,25,2,10,2017-02-20,70,23,2,2,2,1,0,2,12,8,0,1
17020,16,21,24,27,28,4,7,2017-02-22,116,12,2,0,3,2,1,0,11,3,1,1
17021,1,15,17,20,26,6,8,2017-02-25,79,25,3,1,3,1,0,0,14,2,0,1
17022,2,3,9,17,24,6,12,2017-02-27,55,22,3,3,2,0,1,1,18,6,0,1
17023,5,8,12,24,34,7,10,2017-03-01,83,29,1,3,1,1,0,1,17,3,1,1
17024,21,23,29,32,35,11,12,2017-03-04,140,14,4,0,2,3,0,0,23,1,1,1
17025,10,16,19,20,34,4,5,2017-03-06,99,24,1,1,3,1,1,0,9,1,1,0
17026,10,14,19,25,32,2,7,2017-03-08,100,22,2,1,2,2,0,2,9,5,1,1
17027,8,17,25,33,34,3,11,2017-03-11,117,26,3,1,1,3,1,1,14,8,2,1
17028,6,18,22,23,33,9,11,2017-03-13,102,27,2,1,3,1,1,1,20,2,2,1
17029,1,6,14,17,29,1,11,2017-03-15,67,28,3,2,2,1,0,1,12,10,2,1
17030,21,22,24,29,34,5,6,2017-03-18,130,13,2,0,3,2,1,1,11,1,1,0
17031,2,16,17,30,32,2,9,2017-03-20,97,30,1,1,2,2,1,0,11,7,1,1
17032,2,13,14,18,29,3,9,2017-03-22,76,27,2,1,3,1,1,1,12,6,2,1
17033,15,22,23,25,34,5,11,2017-03-25,119,19,3,0,3,2,1,0,16,6,2,1
17034,6,12,21,26,29,2,11,2017-03-27,94,23,2,2,1,2,0,0,13,9,1,1
17035,14,17,22,30,33,7,12,2017-03-29,116,19,2,0,3,2,0,0,19,5,1,1
17036,1,4,9,18,33,2,5,2017-04-01,65,32,3,3,1,1,0,1,7,3,1,0
17037,13,15,16,32,34,6,11,2017-04-03,110,21,2,0,3,2,1,0,17,5,1,1
17038,4,5,13,18,27,3,9,2017-04-05,67,23,3,2,2,1,1,1,12,6,2,1
17039,5,6,14,17,26,3,8,2017-04-08,68,21,2,2,2,1,1,1,11,5,1,1
17040,4,6,10,23,29,9,11,2017-04-10,72,25,2,3,1,1,0,1,20,2,2,1
17041,2,4,6,25,31,5,9,2017-04-12,68,29,2,3,0,2,0,2,14,4,2,1
17042,2,17,31,33,34,1,7,2017-04-15,117,32,3,1,1,3,1,2,8,6,2,1
17043,6,13,22,25,35,9,12,2017-04-17,101,29,3,1,2,2,0,0,21,3,1,1
17044,11,16,17,18,25,2,9,2017-04-19,87,14,3,1,3,1,2,1,11,7,1,1
17045,1,8,11,21,35,9,12,2017-04-22,76,34,4,3,1,1,0,1,21,3,1,1
17046,4,17,20,23,30,2,3,2017-04-24,94,26,2,1,3,1,0,0,5,1,1,0
17047,15,19,32,33,34,9,12,2017-04-26,133,19,3,0,2,3,2,0,21,3,1,1
17048,7,9,13,15,19,3,10,2017-04-29,63,12,5,2,3,0,0,2,13,7,1,1
17049,9,12,14,22,31,5,8,2017-05-01,88,22,2,2,2,1,0,1,13,3,1,1
17050,12,14,17,20,28,2,6,2017-05-03,91,16,1,1,3,1,0,2,8,4,0,0
17051,14,17,18,22,29,10,11,2017-05-06,100,15,2,0,4,1,1,2,21,1,1,1
17052,3,19,24,28,33,4,12,2017-05-08,107,30,3,1,2,2,0,0,16,8,0,1
17053,6,19,20,22,26,1,11,2017-05-10,93,20,1,1,3,1,1,1,12,10,2,1
17054,16,29,30,32,33,4,5,2017-05-13,140,17,2,0,1,4,2,0,9,1,1,0
17055,19,20,22,30,33,3,9,2017-05-15,124,14,2,0,3,2,1,2,12,6,2,1
17056,1,4,24,27,32,3,10,2017-05-17,88,31,2,2,1,2,0,0,13,7,1,1
17057,12,16,19,23,24,2,5,2017-05-20,94,12,2,1,4,0,1,1,7,3,1,0
17058,14,18,20,21,28,3,6,2017-05-22,101,14,1,0,4,1,1,0,9,3,1,0
17059,8,11,13,15,17,3,10,2017-05-24,64,9,4,2,3,0,0,0,13,7,1,1
17060,9,15,20,26,31,5,12,2017-05-27,101,22,3,1,2,2,0,1,17,7,1,1
17061,10,19,23,25,30,2,4,2017-05-29,107,20,3,1,2,2,0,0,6,2,0,0
17062,1,4,6,8,28,8,12,2017-05-31,47,27,1,4,0,1,0,0,20,4,0,1
17063,18,21,22,24,29,5,11,2017-06-03,114,11,2,0,4,1,1,0,16,6,2,1
17064,1,8,20,27,30,3,4,2017-06-05,86,29,2,2,1,2,0,0,7,1,1,0
17065,5,11,12,19,28,5,12,2017-06-07,75,23,3,3,1,1,1,0,17,7,1,1
17066,11,15,23,26,30,2,11,2017-06-10,105,19,3,1,2,2,0,1,13,9,1,1
17067,10,17,18,32,35,10,11,2017-06-12,112,25,2,1,2,2,1,0,21,1,1,1
17068,7,8,19,24,27,6,7,2017-06-14,85,20,3,2,2,1,1,0,13,1,1,1
17069,10,16,20,23,32,8,11,2017-06-17,101,22,1,1,3,1,0,0,19,3,1,1
17070,6,16,18,26,30,2,3,2017-06-19,96,24,0,1,2,2,0,1,5,1,1,0
17071,1,4,11,14,33,5,7,2017-06-21,63,32,3,3,1,1,0,0,12,2,2,1
17072,1,3,29,32,34,2,5,2017-06-24,99,33,3,2,0,3,0,1,7,3,1,0
17073,7,18,28,31,33,1,2,2017-06-26,117,26,3,1,1,3,0,0,3,1,1,0
17074,8,10,11,13,17,8,11,2017-06-28,59,9,3,3,2,0,1,0,19,3,1,1
17075,5,11,16,18,35,1,6,2017-07-01,85,30,3,2,2,1,0,1,7,5,1,0
17076,2,7,25,30,35,7,12,2017-07-03,99,33,3,2,0,3,0,1,19,5,1,1
17077,1,3,4,25,31,6,9,2017-07-05,64,30,4,3,0,2,1,1,15,3,1,1
17078,4,5,27,31,34,3,6,2017-07-08,101,30,3,2,0,3,1,2,9,3,1,0
17079,1,17,19,32,33,2,11,2017-07-10,102,32,4,1,2,2,1,0,13,9,1,1
17080,8,10,21,30,31,2,5,2017-07-12,100,23,2,2,1,2,1,0,7,3,1,0
17081,2,12,15,20,34,1,6,2017-07-15,83,32,1,2,2,1,0,0,7,5,1,0
17082,5,13,20,21,25,8,9,2017-07-17,84,20,4,1,3,1,1,1,17,1,1,1
17083,2,5,14,22,34,3,9,2017-07-19,77,32,1,2,2,1,0,1,12,6,2,1
17084,6,11,14,21,31,9,12,2017-07-22,83,25,3,2,2,1,0,1,21,3,1,1
17085,9,13,14,25,30,2,5,2017-07-24,91,21,3,1,2,2,1,1,7,3,1,0
17086,12,15,18,22,31,1,8,2017-07-26,98,19,2,1,3,1,0,0,9,7,1,1
17087,3,14,21,29,35,2,6,2017-07-29,102,32,4,1,2,2,0,0,8,4,0,0
17088,5,28,31,34,35,8,9,2017-07-31,133,30,3,1,0,4,1,1,17,1,1,1
17089,3,5,6,15,18,3,10,2017-08-02,47,15,3,3,2,0,1,1,13,7,1,1
17090,3,6,15,22,35,9,11,2017-08-05,81,32,3,2,2,1,0,3,20,2,2,1
17091,1,5,7,16,19,3,12,2017-08-07,48,18,4,3,2,0,0,0,15,9,1,1
17092,3,7,9,17,34,4,5,2017-08-09,70,31,4,3,1,1,0,1,9,1,1,0
17093,5,6,17,21,29,2,4,2017-08-12,78,24,4,2,2,1,1,1,6,2,0,0
17094,3,5,8,29,33,4,8,2017-08-14,78,30,4,3,0,2,0,2,12,4,0,1
17095,15,32,33,34,35,3,12,2017-08-16,149,20,3,0,1,4,3,1,15,9,1,1
17096,3,7,9,17,28,4,12,2017-08-19,64,25,4,3,1,1,0,0,16,8,0,1
17097,7,14,19,22,34,7,12,2017-08-21,96,27,2,1,3,1,0,1,19,5,1,1
17098,6,9,17,30,35,10,11,2017-08-23,97,29,3,2,1,2,0,0,21,1,1,1
17099,8,9,17,18,24,3,7,2017-08-26,76,16,2,2,3,0,2,2,10,4,2,1
17100,2,5,18,19,31,1,9,2017-08-28,75,29,3,2,2,1,1,1,10,8,2,1
17101,5,15,21,25,29,5,8,2017-08-30,95,24,5,1,2,2,0,1,13,3,1,1
17102,1,12,23,24,29,8,12,2017-09-02,89,28,3,2,2,1,1,1,20,4,0,1
17103,4,19,20,24,29,3,4,2017-09-04,96,25,2,1,3,1,1,2,7,1,1,0
17104,9,11,22,27,30,9,11,2017-09-06,99,21,3,2,1,2,0,0,20,2,2,1
17105,4,15,22,24,32,2,9,2017-09-09,97,28,1,1,3,1,0,1,11,7,1,1
17106,9,12,18,23,29,2,4,2017-09-11,91,20,3,2,2,1,0,0,6,2,0,0
17107,4,10,19,25,27,6,12,2017-09-13,85,23,3,2,1,2,0,0,18,6,0,1
17108,1,4,15,21,22,4,9,2017-09-16,63,21,3,2,3,0,1,1,13,5,1,1
17109,6,9,19,26,34,5,7,2017-09-18,94,28,2,2,1,2,0,0,12,2,2,1
17110,10,14,20,21,35,2,5,2017-09-20,100,25,2,1,3,1,1,0,7,3,1,0
17111,2,14,17,26,34,8,12,2017-09-23,93,32,1,1,2,2,0,1,20,4,0,1
17112,5,6,20,31,32,6,12,2017-09-25,94,27,2,2,1,2,2,0,18,6,0,1
17113,5,8,17,18,23,4,12,2017-09-27,71,18,3,2,3,0,1,1,16,8,0,1
17114,6,7,12,18,23,1,12,2017-09-30,66,17,2,3,2,0,1,2,13,11,1,1
17115,14,19,20,25,31,6,8,2017-10-02,109,17,3,0,3,2,1,0,14,2,0,1
17116,2,27,30,32,33,1,3,2017-10-04,124,31,2,1,0,4,1,0,4,2,2,0
17117,5,7,9,24,32,8,10,2017-10-07,77,27,3,3,1,1,0,1,18,2,0,1
17118,2,7,16,20,33,3,11,2017-10-09,78,31,2,2,2,1,0,1,14,8,2,1
17119,5,7,13,29,35,3,8,2017-10-11,89,30,5,2,1,2,0,1,11,5,1,1
17120,8,15,24,26,27,5,6,2017-10-14,100,19,2,1,2,2,1,0,11,1,1,0
17121,1,6,12,26,31,1,7,2017-10-16,76,30,2,3,0,2,0,1,8,6,2,1
17122,3,12,18,29,34,3,11,2017-10-18,96,31,2,2,1,2,0,1,14,8,2,1
17123,3,15,23,26,32,1,12,2017-10-21,99,29,3,1,2,2,0,1,13,11,1,1
17124,3,29,30,32,35,3,8,2017-10-23,129,32,3,1,0,4,1,2,11,5,1,1
17125,7,11,18,26,28,4,5,2017-10-25,90,21,2,2,1,2,0,0,9,1,1,0
17126,3,4,13,24,33,1,11,2017-10-28,77,30,3,2,2,1,1,0,12,10,2,1
17127,2,15,18,21,22,3,10,2017-10-30,78,20,2,1,4,0,1,0,13,7,1,1
17128,9,11,13,18,33,2,3,2017-11-01,84,24,4,2,2,1,0,1,5,1,1,0
17129,5,17,20,32,33,4,9,2017-11-04,107,28,3,1,2,2,1,1,13,5,1,1
17130,5,18,28,33,34,3,4,2017-11-06,118,29,2,1,1,3,1,2,7,1,1,0
17131,3,5,8,19,34,1,12,2017-11-08,69,31,3,3,1,1,0,2,13,11,1,1
17132,11,17,23,26,27,1,10,2017-11-11,104,16,4,1,2,2,1,0,11,9,1,1
17133,15,17,19,32,33,1,3,2017-11-13,116,18,4,0,3,2,1,1,4,2,2,0
17134,7,18,19,32,34,2,10,2017-11-15,110,27,2,1,2,2,1,2,12,8,0,1
17135,1,12,15,19,22,2,4,2017-11-18,69,21,3,2,3,0,0,1,6,2,0,0
17136,1,11,20,21,22,3,4,2017-11-20,75,21,3,2,3,0,2,2,7,1,1,0
17137,1,20,22,28,29,5,7,2017-11-22,100,28,2,1,2,2,1,3,12,2,2,1
17138,4,7,9,20,25,2,11,2017-11-25,65,21,3,3,1,1,0,1,13,9,1,1
17139,2,6,19,25,32,9,12,2017-11-27,84,30,2,2,1,2,0,1,21,3,1,1
17140,10,16,25,26,29,1,5,2017-11-29,106,19,2,1,1,3,1,1,6,4,2,0
17141,2,8,21,22,29,3,5,2017-12-02,82,27,2,2,2,1,1,1,8,2,2,0
17142,1,5,16,19,28,2,10,2017-12-04,69,27,3,2,2,1,0,0,12,8,0,1
17143,6,9,24,29,32,2,7,2017-12-06,100,26,2,2,1,2,0,0,9,5,1,1
17144,3,21,23,29,32,10,11,2017-12-09,108,29,4,1,2,2,0,2,21,1,1,1
17145,4,7,17,18,19,3,10,2017-12-11,65,15,3,2,3,0,2,0,13,7,1,1
17146,1,5,11,14,35,9,10,2017-12-13,66,34,4,3,1,1,0,0,19,1,1,1
17147,5,16,17,25,34,1,11,2017-12-16,97,29,3,1,2,2,1,1,12,10,2,1
17148,19,27,31,32,35,11,12,2017-12-18,144,16,4,0,1,4,1,0,23,1,1,1
17149,10,18,19,25,26,4,12,2017-12-20,98,16,2,1,2,2,2,1,16,8,0,1
17150,3,6,10,13,18,9,11,2017-12-23,50,15,2,3,2,0,0,2,20,2,2,1
17151,5,6,23,28,32,4,5,2017-12-25,94,27,2,2,1,2,1,1,9,1,1,0
17152,2,4,7,23,28,2,8,2017-12-27,64,26,2,3,1,1,0,2,10,6,0,1
17153,1,9,24,26,34,9,12,2017-12-30,94,33,2,2,1,2,0,0,21,3,1,1
18001,1,13,22,25,35,3,4,2018-01-01,96,34,4,1,2,2,0,1,7,1,1,0
18002,12,20,23,27,34,1,6,2018-01-03,116,22,2,1,2,2,0,0,7,5,1,0
18003,4,21,23,24,30,9,10,2018-01-06,102,26,2,1,3,1,1,1,19,1,1,1
18004,4,9,22,28,30,1,10,2018-01-08,93,26,1,2,1,2,0,2,11,9,1,1
18005,4,9,23,24,30,8,11,2018-01-10,90,26,2,2,2,1,1,3,19,3,1,1
18006,19,20,30,32,33,3,5,2018-01-13,134,14,2,0,2,3,2,1,8,2,2,0
18007,3,4,28,31,34,4,11,2018-01-15,100,31,2,2,0,3,1,0,15,7,1,1
18008,9,15,17,20,22,10,11,2018-01-17,83,13,3,1,4,0,0,0,21,1,1,1
18009,10,12,28,30,34,3,4,2018-01-20,114,24,0,2,0,3,0,0,7,1,1,0
18010,24,25,26,28,29,4,12,2018-01-22,132,5,2,0,1,4,3,1,16,8,0,1
18011,3,13,15,23,26,1,10,2018-01-24,80,23,4,1,3,1,0,1,11,9,1,1
18012,3,22,24,29,34,7,11,2018-01-27,112,31,2,1,2,2,0,1,18,4,2,1
18013,8,24,31,33,35,7,10,2018-01-29,131,27,3,1,1,3,0,1,17,3,1,1
18014,14,16,18,24,31,1,8,2018-01-31,103,17,1,0,4,1,0,2,9,7,1,1
18015,4,13,15,18,29,5,11,2018-02-03,79,25,3,1,3,1,0,1,16,6,2,1
18016,1,2,12,13,23,9,12,2018-02-05,51,22,3,3,2,0,2,1,21,3,1,1
18017,4,19,21,23,31,4,9,2018-02-07,98,27,4,1,3,1,0,1,13,5,1,1
18018,6,8,13,24,28,6,12,2018-02-10,79,22,1,2,2,1,0,0,18,6,0,1
18019,10,11,19,21,28,5,12,2018-02-12,89,18,3,2,2,1,1,1,17,7,1,1
18020,1,10,13,14,21,9,12,2018-02-14,59,20,3,2,3,0,1,2,21,3,1,1
18021,5,6,8,9,15,4,11,2018-02-24,43,10,3,4,1,0,2,0,15,7,1,1
18022,2,10,19,33,35,5,6,2018-02-26,99,33,3,2,1,2,0,0,11,1,1,0
18023,12,13,18,21,29,2,8,2018-02-28,93,17,3,1,3,1,1,0,10,6,0,1
18024,2,16,24,30,32,4,7,2018-03-03,104,30,0,1,2,2,0,0,11,3,1,1
18025,7,8,9,15,34,7,8,2018-03-05,73,27,3,3,1,1,2,0,15,1,1,1
18026,1,2,3,4,30,3,5,2018-03-07,40,29,2,4,0,1,3,0,8,2,2,0
18027,1,18,20,21,26,4,11,2018-03-10,86,25,2,1,3,1,1,1,15,7,1,1
18028,4,19,25,30,35,4,7,2018-03-12,113,31,3,1,1,3,0,0,11,3,1,1
18029,3,9,21,25,29,1,8,2018-03-14,87,26,5,2,1,2,0,1,9,7,1,1
18030,5,18,21,28,32,9,11,2018-03-17,104,27,2,1,2,2,0,1,20,2,2,1
18031,3,8,13,17,23,5,11,2018-03-19,64,20,4,2,3,0,0,0,16,6,2,1
18032,7,10,17,32,35,5,12,2018-03-21,101,28,3,2,1,2,0,1,17,7,1,1
18033,2,3,19,23,34,4,9,2018-03-24,81,32,3,2,2,1,1,0,13,5,1,1
18034,8,11,22,27,32,3,7,2018-03-26,100,24,2,2,1,2,0,0,10,4,2,1
18035,5,7,10,12,24,7,11,2018-03-28,58,19,2,4,1,0,0,0,18,4,2,1
18036,11,17,18,21,27,7,8,2018-03-31,94,16,4,1,3,1,1,0,15,1,1,1
18037,1,3,27,30,31,2,11,2018-04-02,92,30,4,2,0,3,1,1,13,9,1,1
18038,14,23,25,31,32,1,3,2018-04-04,125,18,3,0,2,3,1,1,4,2,2,0
18039,2,7,14,29,32,10,11,2018-04-07,84,30,2,2,1,2,0,2,21,1,1,1
18040,5,7,18,27,31,1,8,2018-04-09,88,26,4,2,1,2,0,1,9,7,1,1
18041,1,23,25,31,33,1,12,2018-04-11,113,32,5,1,1,3,0,1,13,11,1,1
18042,3,19,25,29,35,5,9,2018-04-14,111,32,5,1,1,3,0,1,14,4,2,1
18043,3,6,13,28,33,4,11,2018-04-16,83,30,3,2,1,2,0,1,15,7,1,1
18044,2,4,6,18,21,5,8,2018-04-18,51,19,1,3,2,0,0,1,13,3,1,1
18045,2,5,20,30,35,5,9,2018-04-21,92,33,2,2,1,2,0,1,14,4,2,1
18046,10,20,22,29,32,5,10,2018-04-23,113,22,1,1,2,2,0,1,15,5,1,1
18047,3,8,10,14,20,4,8,2018-04-25,55,17,1,3,2,0,0,2,12,4,0,1
18048,2,3,11,20,25,2,7,2018-04-28,61,23,3,3,1,1,1,2,9,5,1,1
18049,4,7,9,10,13,6,12,2018-04-30,43,9,3,4,1,0,1,0,18,6,0,1
18050,22,24,26,34,35,6,12,2018-05-02,141,13,1,0,2,3,1,0,18,6,0,1
18051,9,18,28,29,35,3,11,2018-05-05,119,26,3,1,1,3,1,1,14,8,2,1
18052,5,16,18,19,25,2,7,2018-05-07,83,20,3,1,3,1,1,1,9,5,1,1
18053,11,16,21,23,25,2,12,2018-05-09,96,14,4,1,3,1,0,2,14,10,0,1
18054,9,10,12,20,30,1,7,2018-05-12,81,21,1,3,1,1,1,0,8,6,2,1
18055,3,7,20,33,34,9,10,2018-05-14,97,31,3,2,1,2,1,1,19,1,1,1
18056,2,4,16,28,34,5,7,2018-05-16,84,32,0,2,1,2,0,1,12,2,2,1
18057,13,19,22,27,28,5,6,2018-05-19,109,15,3,0,3,2,1,1,11,1,1,0
18058,9,11,12,26,32,4,10,2018-05-21,90,23,2,3,0,2,1,0,14,6,0,1
18059,1,9,10,27,35,6,11,2018-05-23,82,34,4,3,0,2,1,1,17,5,1,1
18060,4,22,27,29,31,2,10,2018-05-26,113,27,3,1,1,3,0,1,12,8,0,1
18061,4,10,12,28,31,8,11,2018-05-28,85,27,1,3,0,2,0,2,19,3,1,1
18062,12,14,19,23,35,2,7,2018-05-30,103,23,3,1,3,1,0,1,9,5,1,1
18063,5,14,15,32,34,3,10,2018-06-02,100,29,2,1,2,2,1,1,13,7,1,1
18064,1,3,4,11,29,2,4,2018-06-04,48,28,4,4,0,1,1,0,6,2,0,0
18065,7,10,28,31,32,8,10,2018-06-06,108,25,2,2,0,3,1,0,18,2,0,1
18066,1,20,23,32,33,1,4,2018-06-09,109,32,3,1,2,2,1,1,5,3,1,0
18067,3,7,12,18,31,7,10,2018-06-11,71,28,3,3,1,1,0,0,17,3,1,1
18068,8,12,16,26,33,5,6,2018-06-13,95,25,1,2,1,2,0,1,11,1,1,0
18069,1,8,13,21,24,2,11,2018-06-16,67,23,3,2,3,0,0,1,13,9,1,1
18070,2,5,10,16,30,4,7,2018-06-18,63,28,1,3,1,1,0,0,11,3,1,1
18071,2,5,23,30,31,3,9,2018-06-20,91,29,3,2,1,2,1,3,12,6,2,1
18072,5,12,17,24,26,1,2,2018-06-23,84,21,2,2,2,1,0,1,3,1,1,0
18073,13,19,24,25,29,2,8,2018-06-25,110,16,4,0,3,2,1,1,10,6,0,1
18074,3,9,12,28,30,4,12,2018-06-27,82,27,2,3,0,2,0,0,16,8,0,1
18075,1,6,12,20,34,4,12,2018-06-30,73,33,1,3,1,1,0,1,16,8,0,1
18076,7,18,28,29,32,6,8,2018-07-02,114,25,2,1,1,3,1,0,14,2,0,1
18077,1,6,9,15,26,8,9,2018-07-04,57,25,3,3,1,1,0,0,17,1,1,1
18078,7,11,12,22,30,3,6,2018-07-07,82,23,2,3,1,1,1,0,9,3,1,0
18079,3,4,10,27,29,1,5,2018-07-09,73,26,3,3,0,2,1,0,6,4,2,0
18080,7,16,24,26,31,10,11,2018-07-11,104,24,2,1,2,2,0,0,21,1,1,1
18081,2,10,13,21,35,1,12,2018-07-14,81,33,3,2,2,1,0,0,13,11,1,1
18082,1,2,14,17,18,8,10,2018-07-16,52,17,2,2,3,0,2,1,18,2,0,1
18083,7,12,25,27,28,10,11,2018-07-18,99,21,3,2,0,3,1,0,21,1,1,1
18084,6,11,17,22,35,11,12,2018-07-21,91,29,3,2,2,1,0,0,23,1,1,1
18085,1,2,14,25,31,5,7,2018-07-23,73,30,3,2,1,2,1,0,12,2,2,1
18086,16,22,24,29,31,4,5,2018-07-25,122,15,2,0,3,2,0,1,9,1,1,0
18087,3,14,19,23,25,1,4,2018-07-28,84,22,4,1,3,1,0,0,5,3,1,0
18088,8,9,21,25,33,1,8,2018-07-30,96,25,4,2,1,2,1,1,9,7,1,1
18089,26,27,28,32,34,6,10,2018-08-01,147,8,1,0,0,5,2,0,16,4,0,1
18090,6,20,24,33,34,4,11,2018-08-04,117,28,1,1,2,2,1,1,15,7,1,1
18091,6,22,26,28,31,1,7,2018-08-06,113,25,1,1,1,3,0,1,8,6,2,1
18092,5,7,14,18,19,4,10,2018-08-08,63,14,3,2,3,0,1,0,14,6,0,1
18093,3,11,16,18,33,3,11,2018-08-11,81,30,3,2,2,1,0,1,14,8,2,1
18094,11,16,25,30,34,8,10,2018-08-13,116,23,2,1,1,3,0,2,18,2,0,1
18095,7,14,18,29,35,5,12,2018-08-15,103,28,3,1,2,2,0,0,17,7,1,1
18096,13,14,20,28,34,6,10,2018-08-18,109,21,1,0,3,2,1,1,16,4,0,1
18097,10,12,14,18,23,1,4,2018-08-20,77,13,1,2,3,0,0,1,5,3,1,0
18098,2,15,18,25,27,5,7,2018-08-22,87,25,3,1,2,2,0,1,12,2,2,1
18099,12,13,16,20,21,1,7,2018-08-25,82,9,2,1,4,0,2,0,8,6,2,1
18100,6,20,21,26,30,6,9,2018-08-27,103,24,1,1,2,2,1,2,15,3,1,1
18101,3,14,15,23,29,4,5,2018-08-29,84,26,4,1,3,1,1,0,9,1,1,0
18102,6,7,13,22,24,10,12,2018-09-01,72,18,2,2,3,0,1,0,22,2,0,1
18103,14,24,26,28,35,2,3,2018-09-03,127,21,1,0,2,3,0,1,5,1,1,0
18104,1,13,14,26,28,7,11,2018-09-05,82,27,2,1,2,2,1,3,18,4,2,1
18105,1,16,19,20,31,2,7,2018-09-08,87,30,3,1,3,1,1,1,9,5,1,1
18106,4,14,17,24,31,1,4,2018-09-10,90,27,2,1,3,1,0,1,5,3,1,0
18107,7,8,9,10,22,3,4,2018-09-12,56,15,2,4,1,0,3,0,7,1,1,0
18108,9,10,24,31,32,7,12,2018-09-15,106,23,2,2,1,2,2,2,19,5,1,1
18109,10,16,23,25,34,2,5,2018-09-17,108,24,2,1,2,2,0,1,7,3,1,0
18110,6,19,21,27,28,3,11,2018-09-19,101,22,3,1,2,2,1,0,14,8,2,1
18111,3,16,27,28,32,4,5,2018-09-22,106,29,2,1,1,3,1,2,9,1,1,0
18112,3,7,8,9,29,9,10,2018-09-24,56,26,4,4,0,1,2,1,19,1,1,1
18113,8,12,27,31,33,4,8,2018-09-26,111,25,3,2,0,3,0,1,12,4,0,1
18114,12,18,26,28,29,5,6,2018-09-29,113,17,1,1,1,3,1,1,11,1,1,0
18115,2,6,13,18,25,1,2,2018-10-01,64,23,2,2,2,1,0,1,3,1,1,0
18116,1,14,17,21,33,7,10,2018-10-03,86,32,4,1,3,1,0,0,17,3,1,1
18117,7,11,13,22,29,3,8,2018-10-06,82,22,4,2,2,1,0,0,11,5,1,1
18118,4,5,14,21,34,6,9,2018-10-08,78,30,2,2,2,1,1,0,15,3,1,1
18119,6,9,11,16,35,2,5,2018-10-10,77,29,3,3,1,1,0,0,7,3,1,0
18120,21,22,25,27,30,8,9,2018-10-13,125,9,3,0,2,3,1,0,17,1,1,1
18121,6,7,21,29,30,1,10,2018-10-15,93,24,3,2,1,2,2,2,11,9,1,1
18122,8,9,21,30,31,5,12,2018-10-17,99,23,3,2,1,2,2,2,17,7,1,1
18123,6,9,29,32,35,2,4,2018-10-20,111,29,3,2,0,3,0,1,6,2,0,0
18124,8,10,12,19,20,10,11,2018-10-22,69,12,1,3,2,0,1,0,21,1,1,1
18125,7,16,20,21,34,4,6,2018-10-24,98,27,2,1,3,1,1,1,10,2,0,0
18126,11,13,15,21,27,5,6,2018-10-27,87,16,5,1,3,1,0,1,11,1,1,0
18127,1,3,4,11,29,8,12,2018-10-29,48,28,4,4,0,1,1,1,20,4,0,1
18128,11,12,14,16,26,8,9,2018-10-31,79,15,1,2,2,1,1,1,17,1,1,1
18129,4,7,21,22,29,3,6,2018-11-03,83,25,3,2,2,1,1,0,9,3,1,0
18130,3,4,16,18,25,1,11,2018-11-05,66,22,2,2,2,1,1,1,12,10,2,1
18131,12,14,21,32,33,2,11,2018-11-07,112,21,2,1,2,2,1,0,13,9,1,1
18132,3,16,22,23,27,1,4,2018-11-10,91,24,3,1,3,1,1,0,5,3,1,0
18133,8,12,14,15,19,1,10,2018-11-12,68,11,2,2,3,0,1,0,11,9,1,1
18134,4,5,19,31,35,2,12,2018-11-14,94,31,4,2,1,2,1,1,14,10,0,1
18135,14,19,23,27,34,6,12,2018-11-17,117,20,3,0,3,2,0,1,18,6,0,1
18136,3,11,12,19,21,5,11,2018-11-19,66,18,4,3,2,0,1,1,16,6,2,1
18137,7,10,22,23,33,8,11,2018-11-21,95,26,3,2,2,1,1,0,19,3,1,1
18138,1,23,24,28,33,4,5,2018-11-24,109,32,3,1,2,2,1,2,9,1,1,0
18139,5,11,16,28,35,6,9,2018-11-26,95,30,3,2,1,2,0,1,15,3,1,1
18140,1,6,8,12,15,3,4,2018-11-28,42,14,2,4,1,0,0,0,7,1,1,0
18141,3,7,23,26,33,4,9,2018-12-01,92,30,4,2,1,2,0,0,13,5,1,1
18142,19,24,28,29,34,10,11,2018-12-03,134,15,2,0,2,3,1,0,21,1,1,1
18143,4,7,20,22,33,1,2,2018-12-05,86,29,2,2,2,1,0,0,3,1,1,0
18144,6,17,18,24,31,7,11,2018-12-08,96,25,2,1,3,1,1,0,18,4,2,1
18145,9,18,29,31,33,6,11,2018-12-10,120,24,4,1,1,3,0,2,17,5,1,1
18146,3,8,9,13,33,1,2,2018-12-12,66,30,4,3,1,1,1,2,3,1,1,0
18147,1,11,26,33,35,2,10,2018-12-15,106,34,4,2,0,3,0,1,12,8,0,1
18148,2,6,24,33,34,2,3,2018-12-17,99,32,1,2,1,2,1,1,5,1,1,0
18149,1,7,10,11,20,3,6,2018-12-19,49,19,3,4,1,0,1,0,9,3,1,0
18150,5,12,13,31,34,10,12,2018-12-22,95,29,3,2,1,2,1,0,22,2,0,1
18151,4,8,18,29,30,3,7,2018-12-24,89,26,1,2,1,2,1,0,10,4,2,1
18152,2,4,5,12,28,8,11,2018-12-26,51,26,1,4,0,1,1,1,19,3,1,1
18153,3,6,7,8,21,1,8,2018-12-29,45,18,3,4,1,0,2,0,9,7,1,1
18154,14,22,23,26,30,3,5,2018-12-31,115,16,1,0,3,2,1,0,8,2,2,0
19001,6,18,23,26,28,3,12,2019-01-02,101,22,1,1,2,2,0,2,15,9,1,1
19002,2,7,14,22,31,1,7,2019-01-05,76,29,2,2,2,1,0,0,8,6,2,1
19003,4,8,18,20,32,10,12,2019-01-07,82,28,0,2,2,1,0,0,22,2,0,1
19004,15,16,17,31,32,3,9,2019-01-09,111,17,3,0,3,2,3,1,12,6,2,1
19005,21,26,27,29,34,5,6,2019-01-12,137,13,3,0,1,4,1,0,11,1,1,0
19006,14,17,19,25,30,4,8,2019-01-14,105,16,3,0,3,2,0,0,12,4,0,1
19007,3,12,16,29,32,1,5,2019-01-16,92,29,2,2,1,2,0,0,6,4,2,0
19008,3,8,17,20,24,6,11,2019-01-19,72,21,2,2,3,0,0,1,17,5,1,1
19009,3,9,15,18,26,6,12,2019-01-21,71,23,3,2,2,1,0,1,18,6,0,1
19010,3,7,24,25,27,2,12,2019-01-23,86,24,4,2,1,2,1,1,14,10,0,1
19011,4,12,13,16,17,4,9,2019-01-26,62,13,2,2,3,0,2,0,13,5,1,1
19012,5,9,17,18,19,7,10,2019-01-28,68,14,4,2,3,0,2,1,17,3,1,1
19013,8,10,15,17,18,1,8,2019-01-30,68,10,2,2,3,0,1,2,9,7,1,1
19014,12,14,20,28,31,9,11,2019-02-02,105,19,1,1,2,2,0,0,20,2,2,1
19015,2,5,10,13,30,4,6,2019-02-11,60,28,2,3,1,1,0,0,10,2,0,0
19016,3,5,13,16,28,2,6,2019-02-13,65,25,3,2,2,1,0,2,8,4,0,0
19017,1,5,7,22,25,3,4,2019-02-16,60,24,4,3,1,1,0,1,7,1,1,0
19018,3,18,19,26,34,6,12,2019-02-18,100,31,2,1,2,2,1,0,18,6,0,1
19019,4,11,19,25,32,1,2,2019-02-20,91,28,3,2,1,2,0,1,3,1,1,0
19020,1,8,16,27,34,3,12,2019-02-23,86,33,2,2,1,2,0,0,15,9,1,1
19021,7,13,17,24,33,1,10,2019-02-25,94,26,4,1,3,1,0,0,11,9,1,1
19022,1,4,14,15,21,1,5,2019-02-27,55,20,3,2,3,0,1,0,6,4,2,0
19023,1,3,14,26,30,6,11,2019-03-02,74,29,2,2,1,2,0,2,17,5,1,1
19024,11,17,19,29,33,8,9,2019-03-04,109,22,5,1,2,2,0,0,17,1,1,1
19025,6,13,16,19,29,3,7,2019-03-06,83,23,3,1,3,1,0,2,10,4,2,1
19026,10,12,15,17,19,2,3,2019-03-09,73,9,3,2,3,0,0,1,5,1,1,0
19027,16,18,24,25,27,2,7,2019-03-11,110,11,2,0,3,2,1,0,9,5,1,1
19028,6,22,28,29,33,2,7,2019-03-13,118,27,2,1,1,3,1,0,9,5,1,1
19029,1,4,18,24,28,2,3,2019-03-16,75,27,1,2,2,1,0,1,5,1,1,0
19030,7,9,13,14,33,2,4,2019-03-18,76,26,4,2,2,1,1,0,6,2,0,0
19031,3,8,21,26,33,4,5,2019-03-20,91,30,3,2,1,2,0,1,9,1,1,0
19032,1,4,7,11,30,7,8,2019-03-23,53,29,3,4,0,1,0,0,15,1,1,1
19033,1,2,4,16,24,7,9,2019-03-25,47,23,1,3,2,0,1,2,16,2,2,1
19034,8,12,15,27,30,1,2,2019-03-27,92,22,2,2,1,2,0,0,3,1,1,0
19035,1,3,5,7,18,8,9,2019-03-30,34,17,4,4,1,0,0,0,17,1,1,1
19036,3,9,21,28,30,1,12,2019-04-01,91,27,3,2,1,2,0,1,13,11,1,1
19037,6,16,26,33,35,4,8,2019-04-03,116,29,2,1,1,3,0,0,12,4,0,1
19038,5,11,16,18,27,7,12,2019-04-06,77,22,3,2,2,1,0,1,19,5,1,1
19039,1,12,18,26,35,6,12,2019-04-08,92,34,2,2,1,2,0,1,18,6,0,1
19040,1,3,31,32,34,1,3,2019-04-10,101,33,3,2,0,3,1,1,4,2,2,0
19041,12,19,20,22,28,2,6,2019-04-13,101,16,1,1,3,1,1,0,8,4,0,0
19042,4,10,13,28,33,11,12,2019-04-15,88,29,2,2,1,2,0,1,23,1,1,1
19043,2,6,7,12,15,6,12,2019-04-17,42,13,2,4,1,0,1,0,18,6,0,1
19044,3,6,10,12,31,1,2,2019-04-20,62,28,2,4,0,1,0,2,3,1,1,0
19045,1,4,16,19,33,3,12,2019-04-22,73,32,3,2,2,1,0,0,15,9,1,1
19046,2,8,14,15,35,10,12,2019-04-24,74,33,2,2,2,1,1,0,22,2,0,1
19047,3,4,10,16,32,4,9,2019-04-27,65,29,1,3,1,1,1,0,13,5,1,1
19048,6,10,16,29,33,5,11,2019-04-29,94,27,2,2,1,2,0,2,16,6,2,1
19049,10,16,22,26,27,7,11,2019-05-01,101,17,1,1,2,2,1,2,18,4,2,1
19050,4,15,16,20,35,3,12,2019-05-04,90,31,2,1,3,1,1,1,15,9,1,1
19051,11,15,16,20,29,4,8,2019-05-06,91,18,3,1,3,1,1,3,12,4,0,1
19052,4,10,15,20,24,7,11,2019-05-08,73,20,1,2,3,0,0,2,18,4,2,1
19053,1,11,19,26,35,11,12,2019-05-11,92,34,4,2,1,2,0,0,23,1,1,1
19054,2,18,23,27,30,5,10,2019-05-13,100,28,2,1,2,2,0,0,15,5,1,1
19055,2,4,6,19,22,2,6,2019-05-15,53,20,1,3,2,0,0,1,8,4,0,0
19056,1,7,10,12,23,6,8,2019-05-18,53,22,3,4,1,0,0,0,14,2,0,1
19057,8,14,16,34,35,6,12,2019-05-20,107,27,1,1,2,2,1,0,18,6,0,1
19058,3,10,13,14,32,7,11,2019-05-22,72,29,2,2,2,1,1,1,18,4,2,1
19059,7,8,15,27,32,8,12,2019-05-25,89,25,3,2,1,2,1,1,20,4,0,1
19060,1,11,12,18,21,8,10,2019-05-27,63,20,3,3,2,0,1,0,18,2,0,1
19061,1,2,13,14,26,5,11,2019-05-29,56,25,2,2,2,1,2,1,16,6,2,1
19062,5,16,23,25,28,1,12,2019-06-01,97,23,3,1,2,2,0,0,13,11,1,1
19063,5,8,15,18,21,4,8,2019-06-03,67,16,3,2,3,0,0,1,12,4,0,1
19064,7,8,13,19,29,11,12,2019-06-05,76,22,4,2,2,1,1,1,23,1,1,1
19065,3,8,10,23,27,2,12,2019-06-08,71,24,3,3,1,1,0,1,14,10,0,1
19066,4,10,11,18,31,5,8,2019-06-10,74,27,2,3,1,1,1,1,13,3,1,1
19067,3,8,11,15,16,2,10,2019-06-12,53,13,3,3,2,0,1,1,12,8,0,1
19068,4,5,8,17,27,6,11,2019-06-15,61,23,3,3,1,1,1,1,17,5,1,1
19069,8,22,23,33,34,4,6,2019-06-17,120,26,2,1,2,2,2,1,10,2,0,0
19070,2,13,15,22,34,2,12,2019-06-19,86,32,2,1,3,1,0,2,14,10,0,1
19071,7,13,14,15,22,7,11,2019-06-22,71,15,3,1,4,0,2,3,18,4,2,1
19072,2,4,6,9,18,7,10,2019-06-24,39,16,1,4,1,0,0,0,17,3,1,1
19073,4,11,19,20,24,8,11,2019-06-26,78,20,2,2,3,0,1,1,19,3,1,1
19074,8,9,13,14,34,5,7,2019-06-29,78,26,2,2,2,1,2,0,12,2,2,1
19075,5,6,7,11,16,2,11,2019-07-01,45,11,3,4,1,0,2,0,13,9,1,1
19076,1,6,11,23,29,1,11,2019-07-03,70,28,4,3,1,1,0,2,12,10,2,1
19077,1,15,17,21,33,7,10,2019-07-06,87,32,5,1,3,1,0,1,17,3,1,1
19078,5,10,21,26,30,1,7,2019-07-08,92,25,2,2,1,2,0,1,8,6,2,1
19079,10,13,16,28,35,4,5,2019-07-10,102,25,2,1,2,2,0,1,9,1,1,0
19080,5,13,18,19,24,2,7,2019-07-13,79,19,3,1,4,0,1,1,9,5,1,1
19081,6,24,26,30,33,2,7,2019-07-15,119,27,1,1,1,3,0,1,9,5,1,1
19082,6,18,20,21,31,3,4,2019-07-17,96,25,2,1,3,1,1,1,7,1,1,0
19083,17,24,26,28,32,7,9,2019-07-20,127,15,1,0,2,3,0,0,16,2,2,1
19084,12,23,25,34,35,1,7,2019-07-22,129,23,3,1,1,3,1,0,8,6,2,1
19085,4,5,6,15,26,8,11,2019-07-24,56,22,2,3,1,1,2,0,19,3,1,1
19086,5,15,16,28,31,2,7,2019-07-27,95,26,3,1,2,2,1,2,9,5,1,1
19087,5,6,18,19,27,7,12,2019-07-29,75,22,3,2,2,1,2,1,19,5,1,1
19088,1,5,18,27,33,6,8,2019-07-31,84,32,4,2,1,2,0,3,14,2,0,1
19089,9,14,18,33,34,3,12,2019-08-03,108,25,2,1,2,2,1,2,15,9,1,1
19090,13,19,28,30,33,2,12,2019-08-05,123,20,3,0,2,3,0,1,14,10,0,1
19091,4,13,20,26,28,3,12,2019-08-07,91,24,1,1,2,2,0,2,15,9,1,1
19092,2,11,15,27,30,2,5,2019-08-10,85,28,3,2,1,2,0,0,7,3,1,0
19093,16,17,26,29,35,1,7,2019-08-12,123,19,3,0,2,3,1,0,8,6,2,1
19094,1,12,14,26,27,7,9,2019-08-14,80,26,2,2,1,2,1,1,16,2,2,1
19095,3,12,17,19,31,2,6,2019-08-17,82,28,4,2,2,1,0,1,8,4,0,0
19096,2,12,22,23,27,2,6,2019-08-19,86,25,2,2,2,1,1,1,8,4,0,0
19097,10,17,20,30,35,10,12,2019-08-21,112,25,2,1,2,2,0,0,22,2,0,1
19098,13,15,17,19,22,3,4,2019-08-24,86,9,4,0,5,0,0,1,7,1,1,0
19099,4,6,18,27,33,7,9,2019-08-26,88,29,2,2,1,2,0,0,16,2,2,1
19100,5,8,12,19,21,6,11,2019-08-28,65,16,3,3,2,0,0,0,17,5,1,1
19101,5,11,18,19,27,5,6,2019-08-31,80,22,4,2,2,1,1,2,11,1,1,0
19102,5,10,15,19,31,3,6,2019-09-02,80,26,4,2,2,1,0,2,9,3,1,0
19103,5,12,22,27,32,4,7,2019-09-04,98,27,2,2,1,2,0,1,11,3,1,1
19104,2,7,19,22,28,3,5,2019-09-07,78,26,2,2,2,1,0,1,8,2,2,0
19105,1,4,9,14,17,1,6,2019-09-09,45,16,3,3,2,0,0,0,7,5,1,0
19106,5,8,10,32,35,2,10,2019-09-11,90,30,2,3,0,2,0,0,12,8,0,1
19107,5,9,19,27,35,2,3,2019-09-14,95,30,5,2,1,2,0,2,5,1,1,0
19108,24,27,28,31,34,4,8,2019-09-16,144,10,2,0,1,4,1,1,12,4,0,1
19109,2,7,8,20,25,11,12,2019-09-18,62,23,2,3,1,1,1,0,23,1,1,1
19110,1,19,23,24,30,4,5,2019-09-21,97,29,3,1,3,1,1,0,9,1,1,0
19111,6,15,20,23,27,8,10,2019-09-23,91,21,3,1,3,1,0,1,18,2,0,1
19112,3,10,16,21,33,5,6,2019-09-25,83,30,3,2,2,1,0,0,11,1,1,0
19113,3,11,27,34,35,1,2,2019-09-28,110,32,4,2,0,3,1,1,3,1,1,0
19114,3,5,7,20,23,4,11,2019-09-30,58,20,4,3,2,0,0,1,15,7,1,1
19115,1,18,21,28,32,5,12,2019-10-09,100,31,2,1,2,2,0,0,17,7,1,1
19116,2,10,16,21,23,2,12,2019-10-12,72,21,2,2,3,0,0,1,14,10,0,1
19117,1,18,21,25,35,7,8,2019-10-14,100,34,4,1,2,2,0,1,15,1,1,1
19118,2,3,13,19,26,2,3,2019-10-16,63,24,3,2,2,1,1,0,5,1,1,0
19119,3,6,9,23,34,2,11,2019-10-19,75,31,3,3,1,1,0,1,13,9,1,1
19120,6,15,17,22,25,1,9,2019-10-21,85,19,3,1,3,1,0,1,10,8,2,1
19121,1,2,3,7,17,4,10,2019-10-23,30,16,4,4,1,0,2,1,14,6,0,1
19122,5,19,25,31,33,10,11,2019-10-26,113,28,5,1,1,3,0,0,21,1,1,1
19123,3,13,15,26,30,5,12,2019-10-28,87,27,3,1,2,2,0,0,17,7,1,1
19124,7,17,26,27,30,6,12,2019-10-30,107,23,3,1,1,3,1,2,18,6,0,1
19125,5,8,9,14,34,2,5,2019-11-02,70,29,2,3,1,1,1,0,7,3,1,0
19126,5,9,16,18,30,4,7,2019-11-04,78,25,2,2,2,1,0,2,11,3,1,1
19127,4,7,8,11,16,9,11,2019-11-06,46,12,2,4,1,0,1,1,20,2,2,1
19128,20,21,25,34,35,3,12,2019-11-09,135,15,3,0,2,3,2,0,15,9,1,1
19129,10,13,18,23,30,6,12,2019-11-11,94,20,2,1,3,1,0,0,18,6,0,1
19130,1,13,20,21,26,4,10,2019-11-13,81,25,3,1,3,1,1,1,14,6,0,1
19131,5,6,14,27,29,6,10,2019-11-16,81,24,3,2,1,2,1,0,16,4,0,1
19132,3,5,6,13,18,10,12,2019-11-18,45,15,3,3,2,0,1,2,22,2,0,1
19133,3,12,24,27,34,1,12,2019-11-20,100,31,2,2,1,2,0,1,13,11,1,1
19134,5,6,7,14,17,10,11,2019-11-23,49,12,3,3,2,0,2,0,21,1,1,1
19135,4,5,19,25,26,1,11,2019-11-25,79,22,3,2,1,2,2,1,12,10,2,1
19136,3,16,20,26,29,3,9,2019-11-27,94,26,2,1,2,2,0,1,12,6,2,1
19137,3,5,12,13,26,7,12,2019-11-30,59,23,3,3,1,1,1,2,19,5,1,1
19138,4,6,7,20,29,2,4,2019-12-02,66,25,2,3,1,1,1,0,6,2,0,0
19139,1,5,7,8,11,6,10,2019-12-04,32,10,4,5,0,0,1,1,16,4,0,1
19140,3,7,8,25,27,3,5,2019-12-07,70,24,4,3,0,2,1,2,8,2,2,0
19141,2,10,20,21,35,1,12,2019-12-09,88,33,2,2,2,1,1,0,13,11,1,1
19142,3,4,26,29,33,6,7,2019-12-11,95,30,3,2,0,3,1,0,13,1,1,1
19143,4,22,23,24,32,6,12,2019-12-14,105,28,1,1,3,1,2,1,18,6,0,1
19144,2,5,20,28,31,2,11,2019-12-16,86,29,2,2,1,2,0,0,13,9,1,1
19145,5,9,19,22,32,3,5,2019-12-18,87,27,3,2,2,1,0,1,8,2,2,0
19146,10,11,26,33,34,1,6,2019-12-21,114,24,2,2,0,3,2,0,7,5,1,0
19147,9,12,19,22,33,7,8,2019-12-23,95,24,3,2,2,1,0,1,15,1,1,1
19148,3,4,7,11,30,8,9,2019-12-25,55,27,3,4,0,1,1,0,17,1,1,1
19149,1,2,7,33,35,6,10,2019-12-28,78,34,4,3,0,2,1,1,16,4,0,1
19150,7,11,12,16,33,5,7,2019-12-30,79,26,3,3,1,1,1,2,12,2,2,1
20001,17,25,26,32,34,4,7,2020-01-01,134,17,2,0,1,4,1,0,11,3,1,1
20002,3,7,18,25,30,2,7,2020-01-04,83,27,3,2,1,2,0,1,9,5,1,1
20003,23,25,26,30,34,3,7,2020-01-06,138,11,2,0,1,4,1,2,10,4,2,1
20004,17,20,21,29,30,5,9,2020-01-08,117,13,3,0,3,2,2,1,14,4,2,1
20005,6,10,33,34,35,1,3,2020-01-11,118,29,2,2,0,3,2,0,4,2,2,0
20006,9,22,25,31,32,8,12,2020-01-13,119,23,3,1,1,3,1,0,20,4,0,1
20007,2,10,19,24,30,5,8,2020-01-15,85,28,1,2,2,1,0,0,13,3,1,1
20008,14,17,19,24,32,1,6,2020-01-18,106,18,2,0,4,1,0,2,7,5,1,0
20009,19,29,31,34,35,6,10,2020-01-20,148,16,4,0,1,4,1,1,16,4,0,1
20010,1,8,13,24,32,2,9,2020-03-14,78,31,2,2,2,1,0,0,11,7,1,1
20011,2,13,19,22,23,2,7,2020-03-16,79,21,3,1,4,0,1,1,9,5,1,1
20012,1,6,18,32,34,1,3,2020-03-18,91,33,1,2,1,2,0,0,4,2,2,0
20013,1,4,5,11,35,3,9,2020-03-21,56,34,4,4,0,1,1,1,12,6,2,1
20014,3,7,9,17,21,3,6,2020-03-23,57,18,5,3,2,0,0,0,9,3,1,0
20015,1,7,23,24,26,3,7,2020-03-25,81,25,3,2,2,1,1,1,10,4,2,1
20016,4,8,19,31,35,1,2,2020-03-28,97,31,3,2,1,2,0,0,3,1,1,0
20017,1,6,7,9,10,2,11,2020-03-30,33,9,3,5,0,0,2,0,13,9,1,1
20018,9,14,16,24,26,4,12,2020-04-01,89,17,1,1,3,1,0,1,16,8,0,1
20019,1,12,22,23,33,1,12,2020-04-04,91,32,3,2,2,1,1,0,13,11,1,1
20020,8,10,12,26,32,5,9,2020-04-06,88,24,0,3,0,2,0,1,14,4,2,1
20021,10,12,24,31,33,4,9,2020-04-08,110,23,2,2,1,2,0,2,13,5,1,1
20022,4,14,20,28,35,2,3,2020-04-11,101,31,1,1,2,2,0,0,5,1,1,0
20023,4,11,23,26,30,1,6,2020-04-13,94,26,2,2,1,2,0,1,7,5,1,0
20024,3,5,6,24,30,3,7,2020-04-15,68,27,2,3,1,1,1,1,10,4,2,1
20025,2,14,21,22,26,5,7,2020-04-18,85,24,1,1,3,1,1,0,12,2,2,1
20026,3,15,26,32,34,8,12,2020-04-20,110,31,2,1,1,3,0,1,20,4,0,1
20027,4,7,20,25,32,3,9,2020-04-22,88,28,2,2,1,2,0,1,12,6,2,1
20028,4,5,28,34,35,1,8,2020-04-25,106,31,2,2,0,3,2,1,9,7,1,1
20029,11,14,17,22,30,7,9,2020-04-27,94,19,2,1,3,1,0,0,16,2,2,1
20030,1,8,17,27,30,5,6,2020-04-29,83,29,3,2,1,2,0,2,11,1,1,0
20031,1,2,5,15,21,4,5,2020-05-02,44,20,4,3,2,0,1,1,9,1,1,0
20032,2,3,9,16,32,3,4,2020-05-04,62,30,2,3,1,1,1,1,7,1,1,0
20033,7,19,20,31,34,5,8,2020-05-06,111,27,3,1,2,2,1,0,13,3,1,1
20034,11,13,20,27,31,2,4,2020-05-09,102,20,4,1,2,2,0,2,6,2,0,0
20035,10,11,22,26,28,2,4,2020-05-11,97,18,1,2,1,2,1,1,6,2,0,0
20036,1,5,11,12,26,2,7,2020-05-13,55,25,3,4,0,1,1,2,9,5,1,1
20037,1,4,10,11,14,2,5,2020-05-16,40,13,2,4,1,0,1,2,7,3,1,0
20038,4,15,20,22,24,1,9,2020-05-18,85,20,1,1,4,0,0,1,10,8,2,1
20039,1,5,15,22,31,2,9,2020-05-20,74,30,4,2,2,1,0,2,11,7,1,1
20040,2,17,20,28,29,1,7,2020-05-23,96,27,2,1,2,2,1,0,8,6,2,1
20041,7,13,20,29,34,4,7,2020-05-25,103,27,3,1,2,2,0,2,11,3,1,1
20042,3,4,5,11,22,5,6,2020-05-27,45,19,3,4,1,0,2,0,11,1,1,0
20043,12,13,17,31,32,1,6,2020-05-30,105,20,3,1,2,2,2,0,7,5,1,0
20044,1,3,22,28,30,2,5,2020-06-01,84,29,2,2,1,2,0,0,7,3,1,0
20045,2,9,16,23,27,3,8,2020-06-03,77,25,3,2,2,1,0,0,11,5,1,1
20046,15,24,27,30,34,4,12,2020-06-06,130,19,2,0,2,3,0,1,16,8,0,1
20047,4,18,27,28,30,3,10,2020-06-08,107,26,1,1,1,3,1,2,13,7,1,1
20048,3,9,10,15,16,7,9,2020-06-10,53,13,3,3,2,0,2,0,16,2,2,1
20049,3,11,15,22,30,8,10,2020-06-13,81,27,3,2,2,1,0,2,18,2,0,1
20050,3,14,16,22,34,2,6,2020-06-15,89,31,1,1,3,1,0,2,8,4,0,0
20051,2,7,9,19,33,1,7,2020-06-17,70,31,4,3,1,1,0,0,8,6,2,1
20052,9,11,26,28,35,6,7,2020-06-20,109,26,3,2,0,3,0,1,13,1,1,1
20053,2,15,18,21,27,3,6,2020-06-22,83,25,3,1,3,1,0,0,9,3,1,0
20054,11,14,15,19,20,3,7,2020-06-24,79,9,3,1,4,0,2,1,10,4,2,1
20055,3,4,12,18,34,10,12,2020-06-27,71,31,1,3,1,1,1,0,22,2,0,1
20056,3,11,25,29,34,3,6,2020-06-29,102,31,4,2,0,3,0,2,9,3,1,0
20057,17,20,21,22,31,2,8,2020-07-01,111,14,3,0,4,1,2,0,10,6,0,1
20058,1,15,19,26,27,5,10,2020-07-04,88,26,4,1,2,2,1,0,15,5,1,1
20059,1,15,22,28,32,3,11,2020-07-06,98,31,2,1,2,2,0,2,14,8,2,1
20060,12,14,25,34,35,3,12,2020-07-08,120,23,2,1,1,3,1,0,15,9,1,1
20061,7,8,12,21,26,1,6,2020-07-11,74,19,2,3,1,1,1,1,7,5,1,0
20062,1,5,14,23,31,2,7,2020-07-13,74,30,4,2,2,1,0,0,9,5,1,1
20063,11,18,20,21,33,6,7,2020-07-15,103,22,3,1,3,1,1,0,13,1,1,1
20064,5,10,23,34,35,1,11,2020-07-18,107,30,3,2,1,2,1,0,12,10,2,1
20065,13,15,26,32,33,5,7,2020-07-20,119,20,3,0,2,3,1,0,12,2,2,1
20066,6,14,21,34,35,3,10,2020-07-22,110,29,2,1,2,2,1,0,13,7,1,1
20067,1,8,14,16,28,4,10,2020-07-25,67,27,1,2,2,1,0,1,14,6,0,1
20068,15,20,23,26,33,2,8,2020-07-27,117,18,3,0,3,2,0,0,10,6,0,1
20069,5,7,26,30,31,7,10,2020-07-29,99,26,3,2,0,3,1,1,17,3,1,1
20070,1,22,30,31,32,4,12,2020-08-01,116,31,2,1,1,3,2,2,16,8,0,1
20071,1,12,16,28,33,3,12,2020-08-03,90,32,2,2,1,2,0,1,15,9,1,1
20072,11,15,18,20,27,5,6,2020-08-05,91,16,3,1,3,1,0,0,11,1,1,0
20073,4,10,12,23,27,8,9,2020-08-08,76,23,2,3,1,1,0,1,17,1,1,1
20074,3,9,10,12,21,4,11,2020-08-10,55,18,3,4,1,0,1,2,15,7,1,1
20075,2,9,10,21,35,1,7,2020-08-12,77,33,3,3,1,1,1,3,8,6,2,1
20076,1,8,18,28,30,10,12,2020-08-15,85,29,1,2,1,2,0,0,22,2,0,1
20077,17,23,28,29,32,1,3,2020-08-17,129,15,3,0,2,3,1,1,4,2,2,0
20078,14,18,20,28,34,10,11,2020-08-19,114,20,0,0,3,2,0,1,21,1,1,1
20079,4,16,24,29,35,2,12,2020-08-22,108,31,2,1,2,2,0,0,14,10,0,1
20080,3,6,22,24,25,9,10,2020-08-24,80,22,2,2,2,1,1,1,19,1,1,1
20081,1,13,15,32,35,8,10,2020-08-26,96,34,4,1,2,2,0,0,18,2,0,1
20082,2,11,12,21,34,4,8,2020-08-29,80,32,2,3,1,1,1,0,12,4,0,1
20083,1,2,17,32,34,4,9,2020-08-31,86,33,2,2,1,2,1,2,13,5,1,1
20084,2,10,20,24,31,6,12,2020-09-02,87,29,1,2,2,1,0,1,18,6,0,1
20085,3,4,11,15,28,2,3,2020-09-05,61,25,3,3,1,1,1,0,5,1,1,0
20086,8,11,15,20,28,4,10,2020-09-07,82,20,2,2,2,1,0,3,14,6,0,1
20087,1,4,20,23,29,4,8,2020-09-09,77,28,3,2,2,1,0,1,12,4,0,1
20088,2,7,23,26,35,1,12,2020-09-12,93,33,3,2,1,2,0,1,13,11,1,1
20089,13,16,20,22,27,1,2,2020-09-14,98,14,2,0,4,1,0,0,3,1,1,0
20090,5,6,27,28,29,11,12,2020-09-16,95,24,3,2,0,3,3,1,23,1,1,1
20091,12,16,20,23,31,5,12,2020-09-19,102,19,2,1,3,1,0,0,17,7,1,1
20092,8,11,17,31,35,7,11,2020-09-21,102,27,4,2,1,2,0,1,18,4,2,1
20093,6,14,25,27,28,4,11,2020-09-23,100,22,2,1,1,3,1,0,15,7,1,1
20094,4,6,7,8,16,2,8,2020-09-26,41,12,1,4,1,0,2,1,10,6,0,1
20095,2,18,25,26,32,2,7,2020-09-28,103,30,1,1,1,3,1,0,9,5,1,1
20096,7,8,10,25,28,3,11,2020-09-30,78,21,2,3,0,2,1,1,14,8,2,1
20097,5,25,27,30,34,6,12,2020-10-05,121,29,3,1,0,4,0,1,18,6,0,1
20098,4,9,15,24,35,4,10,2020-10-07,87,31,3,2,2,1,0,0,14,6,0,1
20099,2,3,11,15,27,4,12,2020-10-10,58,25,4,3,1,1,1,1,16,8,0,1
20100,4,5,8,22,33,7,10,2020-10-12,72,29,2,3,1,1,1,0,17,3,1,1
20101,3,4,5,9,34,7,9,2020-10-14,55,31,3,4,0,1,2,2,16,2,2,1
20102,7,11,18,20,29,9,12,2020-10-17,85,22,3,2,2,1,0,0,21,3,1,1
20103,7,12,13,19,23,2,8,2020-10-19,74,16,4,2,3,0,1,1,10,6,0,1
20104,3,12,23,26,30,4,7,2020-10-21,94,27,2,2,1,2,0,2,11,3,1,1
20105,3,8,12,13,22,4,12,2020-10-24,58,19,2,3,2,0,1,2,16,8,0,1
20106,2,3,11,14,27,4,10,2020-10-26,57,25,3,3,1,1,1,1,14,6,0,1
20107,1,4,13,17,28,3,7,2020-10-28,63,27,3,2,2,1,0,0,10,4,2,1
20108,2,3,6,7,33,8,9,2020-10-31,51,31,3,4,0,1,2,0,17,1,1,1
20109,2,20,21,23,32,6,12,2020-11-02,98,30,2,1,3,1,1,1,18,6,0,1
20110,11,16,20,21,28,5,11,2020-11-04,96,17,2,1,3,1,1,2,16,6,2,1
20111,5,7,9,20,28,2,7,2020-11-07,69,23,3,3,1,1,0,2,9,5,1,1
20112,8,11,13,30,32,2,6,2020-11-09,94,24,2,2,1,2,0,0,8,4,0,0
20113,6,14,18,28,33,2,5,2020-11-11,99,27,1,1,2,2,0,0,7,3,1,0
20114,10,12,21,24,30,3,7,2020-11-14,97,20,1,2,2,1,0,0,10,4,2,1
20115,1,9,18,19,23,1,9,2020-11-16,70,22,4,2,3,0,1,0,10,8,2,1
20116,8,10,12,16,22,3,9,2020-11-18,68,14,0,3,2,0,0,0,12,6,2,1
20117,7,19,20,23,24,5,10,2020-11-21,93,17,3,1,4,0,2,0,15,5,1,1
20118,1,9,15,30,33,4,9,2020-11-23,88,32,4,2,1,2,0,0,13,5,1,1
20119,14,22,24,28,32,7,8,2020-11-25,120,18,0,0,3,2,0,0,15,1,1,1
20120,5,25,26,30,35,4,10,2020-11-28,121,30,3,1,0,4,1,0,14,6,0,1
20121,9,17,27,28,35,3,8,2020-11-30,116,26,4,1,1,3,1,1,11,5,1,1
20122,8,19,29,34,35,6,11,2020-12-02,125,27,3,1,1,3,1,1,17,5,1,1
20123,1,7,11,15,21,4,11,2020-12-05,55,20,5,3,2,0,0,0,15,7,1,1
20124,11,15,24,26,35,4,5,2020-12-07,111,24,3,1,2,2,0,2,9,1,1,0
20125,1,2,3,8,22,1,4,2020-12-09,36,21,2,4,1,0,2,0,5,3,1,0
20126,1,4,9,22,28,4,12,2020-12-12,64,27,2,3,1,1,0,2,16,8,0,1
20127,1,4,17,18,26,3,10,2020-12-14,66,25,2,2,2,1,1,2,13,7,1,1
20128,9,12,13,26,33,4,10,2020-12-16,93,24,3,2,1,2,1,1,14,6,0,1
20129,10,22,27,33,34,1,11,2020-12-19,126,24,2,1,1,3,1,1,12,10,2,1
20130,16,17,23,26,32,2,12,2020-12-21,114,16,2,0,3,2,1,0,14,10,0,1
20131,8,25,27,29,35,2,3,2020-12-23,124,27,4,1,0,4,0,0,5,1,1,0
20132,3,15,16,17,21,7,10,2020-12-26,72,18,4,1,4,0,2,0,17,3,1,1
20133,11,24,26,33,35,8,9,2020-12-28,129,24,3,1,1,3,0,0,17,1,1,1
20134,8,11,13,22,25,4,7,2020-12-30,79,17,3,2,2,1,0,1,11,3,1,1
21001,2,6,12,19,33,8,9,2021-01-02,72,31,2,3,1,1,0,0,17,1,1,1
21002,2,16,26,31,34,9,11,2021-01-04,109,32,1,1,1,3,0,1,20,2,2,1
21003,7,21,28,31,35,4,10,2021-01-06,122,28,4,1,1,3,0,1,14,6,0,1
21004,5,10,17,23,28,2,8,2021-01-09,83,23,3,2,2,1,0,1,10,6,0,1
21005,3,7,10,12,35,3,5,2021-01-11,67,32,3,4,0,1,0,1,8,2,2,0
21006,4,22,25,28,35,4,5,2021-01-13,114,31,2,1,1,3,0,1,9,1,1,0
21007,5,23,30,34,35,8,10,2021-01-16,127,30,3,1,1,3,1,1,18,2,0,1
21008,5,19,20,27,33,3,8,2021-01-18,104,28,4,1,2,2,1,1,11,5,1,1
21009,1,3,20,29,32,5,12,2021-01-20,85,31,3,2,1,2,0,1,17,7,1,1
21010,1,5,16,22,34,8,11,2021-01-23,78,33,2,2,2,1,0,1,19,3,1,1
21011,6,9,11,14,21,1,3,2021-01-25,61,15,3,3,2,0,0,0,4,2,2,0
21012,6,12,20,23,33,1,9,2021-01-27,94,27,2,2,2,1,0,1,10,8,2,1
21013,21,27,28,30,34,8,11,2021-01-30,140,13,2,0,1,4,1,0,19,3,1,1
21014,7,13,20,27,29,4,9,2021-02-01,96,22,4,1,2,2,0,1,13,5,1,1
21015,4,8,17,19,25,1,7,2021-02-03,73,21,3,2,2,1,0,0,8,6,2,1
21016,8,9,10,19,34,1,2,2021-02-06,80,26,2,3,1,1,2,2,3,1,1,0
21017,17,21,26,29,32,2,7,2021-02-08,125,15,3,0,2,3,0,0,9,5,1,1
21018,2,20,23,26,34,5,10,2021-02-20,105,32,1,1,2,2,0,1,15,5,1,1
21019,1,12,13,28,29,3,4,2021-02-22,83,28,3,2,1,2,2,0,7,1,1,0
21020,7,21,22,30,33,4,6,2021-02-24,113,26,3,1,2,2,1,0,10,2,0,0
21021,16,18,29,33,35,9,12,2021-02-27,131,19,3,0,2,3,0,1,21,3,1,1
21022,2,12,22,30,33,2,4,2021-03-01,99,31,1,2,1,2,0,1,6,2,0,0
21023,7,9,13,16,32,2,9,2021-03-03,77,25,3,2,2,1,0,0,11,7,1,1
21024,11,14,21,24,31,2,10,2021-03-06,101,20,3,1,3,1,0,0,12,8,0,1
21025,17,18,23,30,31,10,12,2021-03-08,119,14,3,0,3,2,2,1,22,2,0,1
21026,7,11,20,24,27,1,11,2021-03-10,89,20,3,2,2,1,0,0,12,10,2,1
21027,9,21,22,26,30,4,12,2021-03-13,108,21,2,1,2,2,1,0,16,8,0,1
21028,2,3,5,17,29,4,10,2021-03-15,56,27,4,3,1,1,1,0,14,6,0,1
21029,2,6,10,32,33,4,7,2021-03-17,83,31,1,3,0,2,1,1,11,3,1,1
21030,18,23,25,26,32,2,7,2021-03-20,124,14,2,0,2,3,1,1,9,5,1,1
21031,1,4,19,20,34,3,5,2021-03-22,78,33,2,2,2,1,1,0,8,2,2,0
21032,1,11,14,34,35,7,10,2021-03-24,95,34,3,2,1,2,1,2,17,3,1,1
21033,1,3,5,30,32,1,5,2021-03-27,71,31,3,3,0,2,0,1,6,4,2,0
21034,8,10,14,25,34,7,8,2021-03-29,91,26,1,2,1,2,0,0,15,1,1,1
21035,5,11,16,30,32,3,4,2021-03-31,94,27,2,2,1,2,0,0,7,1,1,0
21036,8,17,25,28,33,7,11,2021-04-03,111,25,3,1,1,3,0,0,18,4,2,1
21037,10,21,27,29,33,4,12,2021-04-05,120,23,4,1,1,3,0,1,16,8,0,1
21038,9,11,20,29,32,1,7,2021-04-07,101,23,3,2,1,2,0,1,8,6,2,1
21039,4,12,14,21,35,2,11,2021-04-10,86,31,2,2,2,1,0,0,13,9,1,1
21040,2,3,9,16,19,3,7,2021-04-12,49,17,3,3,2,0,1,0,10,4,2,1
21041,2,5,9,11,32,4,9,2021-04-14,59,30,3,4,0,1,0,2,13,5,1,1
21042,9,15,20,23,29,4,5,2021-04-17,96,20,4,1,3,1,0,1,9,1,1,0
21043,7,12,17,19,34,1,10,2021-04-19,89,27,3,2,2,1,0,0,11,9,1,1
21044,6,18,31,33,35,10,11,2021-04-21,123,29,3,1,1,3,0,0,21,1,1,1
21045,1,4,6,11,19,7,9,2021-04-24,41,18,3,4,1,0,0,1,16,2,2,1
21046,6,8,12,14,18,6,8,2021-04-26,58,12,0,3,2,0,0,1,14,2,0,1
21047,1,6,9,25,33,4,8,2021-04-28,74,32,4,3,0,2,0,1,12,4,0,1
21048,4,7,17,21,27,10,12,2021-05-01,76,23,4,2,2,1,0,0,22,2,0,1
21049,1,10,22,23,25,2,12,2021-05-03,81,24,3,2,2,1,1,0,14,10,0,1
21050,9,22,32,33,35,5,10,2021-05-05,131,26,3,1,1,3,1,1,15,5,1,1
21051,1,4,14,16,19,3,4,2021-05-08,54,18,2,2,3,0,0,0,7,1,1,0
21052,2,11,13,14,30,9,12,2021-05-10,70,28,2,2,2,1,1,1,21,3,1,1
21053,3,6,15,17,35,7,11,2021-05-12,76,32,4,2,2,1,0,0,18,4,2,1
21054,3,6,17,20,25,3,9,2021-05-15,71,22,3,2,2,1,0,3,12,6,2,1
21055,3,6,10,11,24,10,11,2021-05-17,54,21,2,4,1,0,1,2,21,1,1,1
21056,3,11,16,21,26,9,10,2021-05-19,77,23,3,2,2,1,0,2,19,1,1,1
21057,5,7,19,20,28,5,7,2021-05-22,79,23,3,2,2,1,1,0,12,2,2,1
21058,13,15,17,23,34,1,11,2021-05-24,102,21,4,0,4,1,0,0,12,10,2,1
21059,4,16,27,28,35,2,9,2021-05-26,110,31,2,1,1,3,1,0,11,7,1,1
21060,9,13,25,31,33,3,7,2021-05-29,111,24,5,1,1,3,0,0,10,4,2,1
21061,15,19,20,26,32,4,7,2021-05-31,112,17,2,0,3,2,1,0,11,3,1,1
21062,4,6,23,32,34,5,7,2021-06-02,99,30,1,2,1,2,0,1,12,2,2,1
21063,5,9,14,29,30,9,11,2021-06-05,87,25,3,2,1,2,1,0,20,2,2,1
21064,1,17,19,32,34,6,10,2021-06-07,103,33,3,1,2,2,0,0,16,4,0,1
21065,23,25,30,31,35,7,8,2021-06-09,144,12,4,0,1,4,1,0,15,1,1,1
21066,24,26,29,34,35,9,11,2021-06-12,148,11,2,0,1,4,1,1,20,2,2,1
21067,1,4,22,23,34,8,9,2021-06-14,84,33,2,2,2,1,1,1,17,1,1,1
21068,2,20,21,26,30,2,10,2021-06-16,99,28,1,1,2,2,1,0,12,8,0,1
21069,1,3,24,32,33,4,6,2021-06-19,93,32,3,2,1,2,1,0,10,2,0,0
21070,3,20,21,22,24,6,12,2021-06-21,90,21,2,1,4,0,2,2,18,6,0,1
21071,8,11,16,29,35,1,4,2021-06-23,99,27,3,2,1,2,0,0,5,3,1,0
21072,2,3,15,22,26,3,11,2021-06-26,68,24,2,2,2,1,1,0,14,8,2,1
21073,8,12,14,20,24,6,10,2021-06-28,78,16,0,2,3,0,0,0,16,4,0,1
21074,11,14,18,20,25,3,7,2021-06-30,88,14,2,1,3,1,0,2,10,4,2,1
21075,6,14,15,17,20,1,5,2021-07-03,72,14,2,1,4,0,1,2,6,4,2,0
21076,6,13,22,25,26,2,4,2021-07-05,92,20,2,1,2,2,1,1,6,2,0,0
21077,2,6,9,21,25,6,8,2021-07-07,63,23,3,3,1,1,0,2,14,2,0,1
21078,2,8,17,19,25,1,5,2021-07-10,71,23,3,2,2,1,0,2,6,4,2,0
21079,6,14,19,26,33,8,11,2021-07-12,98,27,2,1,2,2,0,1,19,3,1,1
21080,15,16,20,29,30,6,10,2021-07-14,110,15,2,0,3,2,2,0,16,4,0,1
21081,5,13,24,29,35,7,8,2021-07-17,106,30,4,1,2,2,0,1,15,1,1,1
21082,1,14,22,29,33,3,10,2021-07-19,99,32,3,1,2,2,0,1,13,7,1,1
21083,7,9,11,26,35,1,8,2021-07-21,88,28,4,3,0,2,0,0,9,7,1,1
21084,2,10,14,30,33,6,9,2021-07-24,89,31,1,2,1,2,0,0,15,3,1,1
21085,1,12,15,26,35,10,11,2021-07-26,89,34,3,2,1,2,0,0,21,1,1,1
21086,2,3,7,16,17,6,10,2021-07-28,45,15,3,3,2,0,2,0,16,4,0,1
21087,10,14,15,25,28,3,10,2021-07-31,92,18,2,1,2,2,1,0,13,7,1,1
21088,2,14,31,34,35,1,7,2021-08-02,116,33,2,1,1,3,1,1,8,6,2,1
21089,1,17,24,28,35,10,12,2021-08-04,105,34,3,1,2,2,0,1,22,2,0,1
21090,6,7,19,26,32,6,12,2021-08-07,90,26,2,2,1,2,1,0,18,6,0,1
21091,1,4,10,21,29,3,5,2021-08-09,65,28,3,3,1,1,0,0,8,2,2,0
21092,12,14,27,28,34,3,7,2021-08-11,115,22,1,1,1,3,1,0,10,4,2,1
21093,20,25,27,28,31,8,11,2021-08-14,131,11,3,0,1,4,1,2,19,3,1,1
21094,5,6,24,27,33,5,12,2021-08-16,95,28,3,2,1,2,1,1,17,7,1,1
21095,10,15,19,20,30,11,12,2021-08-18,94,20,2,1,3,1,1,0,23,1,1,1
21096,7,8,10,20,21,1,5,2021-08-21,66,14,2,3,2,0,2,2,6,4,2,0
21097,11,26,30,31,33,3,10,2021-08-23,131,22,3,1,0,4,1,0,13,7,1,1
21098,2,7,21,27,33,7,9,2021-08-25,90,31,4,2,1,2,0,1,16,2,2,1
21099,15,19,27,28,30,3,4,2021-08-28,119,15,3,0,2,3,1,1,7,1,1,0
21100,7,11,23,26,28,2,7,2021-08-30,95,21,3,2,1,2,0,1,9,5,1,1
21101,13,18,19,27,32,6,11,2021-09-01,109,19,3,0,3,2,1,0,17,5,1,1
21102,2,8,11,16,23,2,7,2021-09-04,60,21,2,3,2,0,0,0,9,5,1,1
21103,4,10,23,30,31,5,11,2021-09-06,98,27,2,2,1,2,1,1,16,6,2,1
21104,23,25,26,30,33,3,11,2021-09-08,137,10,3,0,1,4,1,2,14,8,2,1
21105,7,10,11,17,18,4,9,2021-09-11,63,11,3,3,2,0,2,0,13,5,1,1
21106,2,13,14,32,34,2,12,2021-09-13,95,32,1,1,2,2,1,0,14,10,0,1
21107,3,5,13,20,25,7,11,2021-09-15,66,22,4,2,2,1,0,1,18,4,2,1
21108,5,19,22,26,35,2,6,2021-09-18,107,30,3,1,2,2,0,1,8,4,0,0
21109,3,4,7,27,31,6,9,2021-09-20,72,28,4,3,0,2,1,0,15,3,1,1
21110,11,14,29,31,32,11,12,2021-09-22,117,21,3,1,1,3,1,1,23,1,1,1
21111,7,8,15,19,28,8,9,2021-09-25,77,21,3,2,2,1,1,0,17,1,1,1
21112,18,21,22,23,35,11,12,2021-09-27,119,17,3,0,4,1,2,0,23,1,1,1
21113,17,18,25,27,28,4,8,2021-09-29,115,11,3,0,2,3,2,1,12,4,0,1
21114,8,9,13,29,30,1,11,2021-10-06,89,22,3,2,1,2,2,0,12,10,2,1
21115,8,13,19,20,29,6,10,2021-10-09,89,21,3,1,3,1,1,3,16,4,0,1
21116,4,25,28,29,35,3,11,2021-10-11,121,31,3,1,0,4,1,1,14,8,2,1
21117,11,18,21,22,33,5,6,2021-10-13,105,22,3,1,3,1,1,0,11,1,1,0
21118,14,17,18,28,34,2,3,2021-10-16,111,20,1,0,3,2,1,1,5,1,1,0
21119,1,2,9,16,30,9,10,2021-10-18,58,29,2,3,1,1,1,0,19,1,1,1
21120,5,10,21,25,31,5,11,2021-10-20,92,26,4,2,1,2,0,0,16,6,2,1
21121,2,15,19,29,30,2,9,2021-10-23,95,28,3,1,2,2,1,0,11,7,1,1
21122,14,15,26,27,29,4,5,2021-10-25,111,15,3,0,2,3,2,2,9,1,1,0
21123,8,23,26,27,33,8,9,2021-10-27,117,25,3,1,1,3,1,2,17,1,1,1
21124,10,17,22,25,35,7,9,2021-10-30,109,25,3,1,2,2,0,0,16,2,2,1
21125,17,19,21,27,31,4,9,2021-11-01,115,14,5,0,3,2,0,1,13,5,1,1
21126,1,11,12,34,35,9,12,2021-11-03,93,34,3,3,0,2,2,0,21,3,1,1
21127,1,2,15,17,26,2,11,2021-11-06,61,25,3,2,2,1,1,1,13,9,1,1
21128,14,17,18,23,27,5,8,2021-11-08,99,13,3,0,4,1,1,1,13,3,1,1
21129,2,16,17,18,34,4,10,2021-11-10,87,32,1,1,3,1,2,2,14,6,0,1
21130,2,3,14,27,28,5,10,2021-11-13,74,26,2,2,1,2,2,1,15,5,1,1
21131,6,8,16,34,35,5,6,2021-11-15,99,29,1,2,1,2,1,0,11,1,1,0
21132,4,21,28,29,33,3,11,2021-11-17,115,29,3,1,1,3,1,0,14,8,2,1
21133,8,9,17,26,28,6,8,2021-11-20,88,20,2,2,1,2,1,1,14,2,0,1
21134,2,6,14,19,28,1,6,2021-11-22,69,26,1,2,2,1,0,1,7,5,1,0
21135,4,7,17,29,31,5,6,2021-11-24,88,27,4,2,1,2,0,0,11,1,1,0
21136,8,12,19,27,33,2,5,2021-11-27,99,25,3,2,1,2,0,0,7,3,1,0
21137,2,7,13,14,19,4,5,2021-11-29,55,17,3,2,3,0,1,1,9,1,1,0
21138,9,11,12,15,31,5,11,2021-12-01,78,22,4,3,1,1,1,0,16,6,2,1
21139,5,13,18,23,34,8,9,2021-12-04,93,29,3,1,3,1,0,0,17,1,1,1
21140,5,24,26,33,35,9,12,2021-12-06,123,30,3,1,1,3,0,1,21,3,1,1
21141,2,8,16,29,34,5,12,2021-12-08,89,32,1,2,1,2,0,0,17,7,1,1
21142,11,13,17,19,25,2,9,2021-12-11,85,14,5,1,3,1,0,0,11,7,1,1
21143,9,17,19,29,34,4,11,2021-12-13,108,25,4,1,2,2,0,2,15,7,1,1
21144,3,20,25,30,34,2,9,2021-12-15,112,31,2,1,1,3,0,1,11,7,1,1
21145,3,8,25,29,30,1,6,2021-12-18,95,27,3,2,0,3,1,3,7,5,1,0
21146,3,5,8,18,20,9,11,2021-12-20,54,17,2,3,2,0,0,2,20,2,2,1
21147,1,2,8,12,26,1,7,2021-12-22,49,25,1,4,0,1,1,1,8,6,2,1
21148,1,4,12,16,29,4,8,2021-12-25,62,28,2,3,1,1,0,2,12,4,0,1
21149,20,26,28,30,35,10,11,2021-12-27,139,15,1,0,1,4,0,0,21,1,1,1
21150,4,10,11,23,26,7,10,2021-12-29,74,22,2,3,1,1,1,1,17,3,1,1
22001,8,11,19,22,29,3,11,2022-01-01,89,21,3,2,2,1,0,1,14,8,2,1
22002,4,6,7,9,24,4,12,2022-01-03,50,20,2,4,1,0,1,0,16,8,0,1
22003,2,18,24,25,34,8,12,2022-01-05,103,32,1,1,2,2,1,1,20,4,0,1
22004,7,20,27,30,33,3,4,2022-01-08,117,26,3,1,1,3,0,0,7,1,1,0
22005,2,13,17,19,34,5,9,2022-01-10,85,32,3,1,3,1,0,0,14,4,2,1
22006,1,5,7,17,20,5,12,2022-01-12,50,19,4,3,2,0,0,1,17,7,1,1
22007,5,22,23,25,35,3,11,2022-01-15,110,30,4,1,2,2,1,1,14,8,2,1
22008,1,2,13,18,34,6,7,2022-01-17,68,33,2,2,2,1,1,0,13,1,1,1
22009,13,14,18,31,33,7,10,2022-01-19,109,20,3,0,3,2,1,2,17,3,1,1
22010,4,19,25,31,35,2,11,2022-01-22,114,31,4,1,1,3,0,1,13,9,1,1
22011,3,5,17,24,32,5,12,2022-01-24,81,29,3,2,2,1,0,0,17,7,1,1
22012,3,5,10,33,34,7,10,2022-01-26,85,31,3,3,0,2,1,2,17,3,1,1
22013,4,9,16,25,32,5,6,2022-02-09,86,28,2,2,1,2,0,0,11,1,1,0
22014,1,4,10,18,32,1,9,2022-02-12,65,31,1,3,1,1,0,2,10,8,2,1
22015,1,2,8,12,30,5,12,2022-02-14,53,29,1,4,0,1,1,1,17,7,1,1
22016,1,7,17,26,32,1,9,2022-02-16,83,31,3,2,1,2,0,1,10,8,2,1
22017,10,14,18,23,25,7,11,2022-02-19,90,15,2,1,3,1,0,0,18,4,2,1
22018,16,21,29,31,34,6,9,2022-02-21,131,18,3,0,2,3,0,0,15,3,1,1
22019,1,4,7,17,21,1,2,2022-02-23,50,20,4,3,2,0,0,1,3,1,1,0
22020,16,17,30,31,35,8,9,2022-02-26,129,19,3,0,2,3,2,1,17,1,1,1
22021,11,15,16,18,35,6,9,2022-02-28,95,24,3,1,3,1,1,2,15,3,1,1
22022,1,5,14,17,28,6,7,2022-03-02,65,27,3,2,2,1,0,0,13,1,1,1
22023,4,5,18,20,25,11,12,2022-03-05,72,21,2,2,2,1,1,1,23,1,1,1
22024,1,2,11,30,35,1,12,2022-03-07,79,34,3,3,0,2,1,0,13,11,1,1
22025,4,7,22,24,29,1,7,2022-03-09,86,25,2,2,2,1,0,0,8,6,2,1
22026,11,14,22,23,27,8,10,2022-03-12,97,16,3,1,3,1,1,1,18,2,0,1
22027,3,6,11,31,32,5,12,2022-03-14,83,29,3,3,0,2,1,1,17,7,1,1
22028,4,9,16,17,35,1,7,2022-03-16,81,31,3,2,2,1,1,0,8,6,2,1
22029,7,8,10,14,17,10,12,2022-03-19,56,10,2,3,2,0,1,1,22,2,0,1
22030,12,14,15,21,30,1,9,2022-03-21,92,18,2,1,3,1,1,1,10,8,2,1
22031,7,14,16,20,28,4,8,2022-03-23,85,21,1,1,3,1,0,1,12,4,0,1
22032,5,9,18,31,32,1,5,2022-03-26,95,27,3,2,1,2,1,0,6,4,2,0
22033,8,15,16,19,33,3,4,2022-03-28,91,25,3,1,3,1,1,0,7,1,1,0
22034,2,10,24,27,28,6,7,2022-03-30,91,26,1,2,1,2,1,0,13,1,1,1
22035,9,11,13,23,31,5,8,2022-04-02,87,22,5,2,2,1,0,0,13,3,1,1
22036,18,19,21,26,34,6,7,2022-04-04,118,16,2,0,3,2,1,0,13,1,1,1
22037,1,9,17,20,28,6,10,2022-04-06,75,27,3,2,2,1,0,0,16,4,0,1
22038,7,9,11,12,26,9,12,2022-04-09,65,19,3,4,0,1,1,1,21,3,1,1
22039,1,8,11,22,31,5,11,2022-04-11,73,30,3,3,1,1,0,1,16,6,2,1
22040,10,19,25,29,33,8,12,2022-04-13,116,23,4,1,1,3,0,0,20,4,0,1
22041,5,15,25,26,33,6,11,2022-04-16,104,28,4,1,1,3,1,2,17,5,1,1
22042,8,10,11,29,32,2,6,2022-04-18,90,24,2,3,0,2,1,0,8,4,0,0
22043,2,16,17,24,30,9,12,2022-04-20,89,28,1,1,3,1,1,0,21,3,1,1
22044,1,2,16,17,20,3,7,2022-04-23,56,19,2,2,3,0,2,3,10,4,2,1
22045,2,3,7,12,20,1,5,2022-04-25,44,18,2,4,1,0,1,2,6,4,2,0
22046,6,7,12,22,27,3,5,2022-04-27,74,21,2,3,1,1,1,2,8,2,2,0
22047,7,10,11,12,33,3,11,2022-04-30,73,26,3,4,0,1,2,2,14,8,2,1
22048,16,22,28,29,32,8,9,2022-05-02,127,16,1,0,2,3,1,0,17,1,1,1
22049,6,10,20,28,35,1,10,2022-05-04,99,29,1,2,1,2,0,1,11,9,1,1
22050,2,10,21,24,30,8,10,2022-05-07,87,28,1,2,2,1,0,1,18,2,0,1
22051,1,16,17,19,33,5,6,2022-05-09,86,32,4,1,3,1,1,0,11,1,1,0
22052,1,13,18,29,35,4,9,2022-05-11,96,34,4,1,2,2,0,1,13,5,1,1
22053,9,17,19,20,25,1,9,2022-05-14,90,16,4,1,3,1,1,0,10,8,2,1
22054,5,16,21,23,34,7,10,2022-05-16,99,29,3,1,3,1,0,0,17,3,1,1
22055,1,2,12,15,23,4,6,2022-05-18,53,22,3,3,2,0,1,1,10,2,0,0
22056,2,11,15,17,31,7,9,2022-05-21,76,29,4,2,2,1,0,2,16,2,2,1
22057,6,12,18,21,35,7,10,2022-05-23,92,29,2,2,2,1,0,0,17,3,1,1
22058,3,4,24,26,35,7,8,2022-05-25,92,32,2,2,1,2,1,1,15,1,1,1
22059,4,15,18,32,34,4,9,2022-05-28,103,30,1,1,2,2,0,1,13,5,1,1
22060,2,6,10,11,20,3,9,2022-05-30,49,18,1,4,1,0,1,0,12,6,2,1
22061,6,9,19,22,30,1,6,2022-06-01,86,24,2,2,2,1,0,1,7,5,1,0
22062,5,9,11,12,31,7,11,2022-06-04,68,26,4,4,0,1,1,1,18,4,2,1
22063,2,3,22,26,31,6,10,2022-06-06,84,29,2,2,1,2,1,1,16,4,0,1
22064,2,19,22,25,35,5,7,2022-06-08,103,33,3,1,2,2,0,2,12,2,2,1
22065,5,10,13,22,28,1,4,2022-06-11,78,23,2,2,2,1,0,1,5,3,1,0
22066,2,24,25,26,34,3,12,2022-06-13,111,32,1,1,1,3,2,0,15,9,1,1
22067,4,14,15,32,33,10,11,2022-06-15,98,29,2,1,2,2,2,0,21,1,1,1
22068,3,6,10,15,23,3,8,2022-06-18,57,20,3,3,2,0,0,1,11,5,1,1
22069,2,3,23,28,35,2,9,2022-06-20,91,33,3,2,1,2,1,2,11,7,1,1
22070,1,7,17,23,35,7,11,2022-06-22,83,34,5,2,2,1,0,2,18,4,2,1
22071,9,15,19,25,29,8,9,2022-06-25,97,20,5,1,2,2,0,0,17,1,1,1
22072,1,12,13,15,30,3,7,2022-06-27,71,29,3,2,2,1,1,1,10,4,2,1
22073,11,18,21,25,32,2,4,2022-06-29,107,21,3,1,2,2,0,0,6,2,0,0
22074,2,6,21,25,28,2,6,2022-07-02,82,26,2,2,1,2,0,2,8,4,0,0
22075,4,12,13,17,18,7,9,2022-07-04,64,14,2,2,3,0,2,0,16,2,2,1
22076,5,17,30,34,35,2,9,2022-07-06,121,30,3,1,1,3,1,1,11,7,1,1
22077,5,10,11,16,19,1,10,2022-07-09,61,14,3,3,2,0,1,1,11,9,1,1
22078,2,3,18,20,27,1,2,2022-07-11,70,25,2,2,2,1,1,0,3,1,1,0
22079,7,10,19,26,32,8,12,2022-07-13,94,25,2,2,1,2,0,0,20,4,0,1
22080,10,17,30,31,34,3,6,2022-07-16,122,24,2,1,1,3,1,1,9,3,1,0
22081,5,10,19,31,32,9,10,2022-07-18,97,27,3,2,1,2,1,2,19,1,1,1
22082,4,26,27,30,33,2,9,2022-07-20,120,29,2,1,0,4,1,0,11,7,1,1
22083,2,9,17,26,32,4,6,2022-07-23,86,30,2,2,1,2,0,1,10,2,0,0
22084,3,11,19,25,27,4,12,2022-07-25,85,24,5,2,1,2,0,0,16,8,0,1
22085,11,16,31,33,35,6,8,2022-07-27,126,24,4,1,1,3,0,1,14,2,0,1
22086,4,10,21,28,31,8,11,2022-07-30,94,27,2,2,1,2,0,1,19,3,1,1
22087,4,6,10,24,28,6,12,2022-08-01,72,24,0,3,1,1,0,3,18,6,0,1
22088,1,8,10,20,35,6,11,2022-08-03,74,34,2,3,1,1,0,1,17,5,1,1
22089,1,20,21,31,33,3,11,2022-08-06,106,32,4,1,2,2,1,2,14,8,2,1
22090,1,20,24,25,31,9,12,2022-08-08,101,30,3,1,2,2,1,3,21,3,1,1
22091,2,11,20,22,34,4,12,2022-08-10,89,32,1,2,2,1,0,1,16,8,0,1
22092,1,4,12,23,29,5,12,2022-08-13,69,28,3,3,1,1,0,0,17,7,1,1
22093,7,11,14,21,29,7,10,2022-08-15,82,22,4,2,2,1,0,1,17,3,1,1
22094,3,4,7,12,19,2,5,2022-08-17,45,16,3,4,1,0,1,1,7,3,1,0
22095,5,8,22,25,35,2,7,2022-08-20,95,30,3,2,1,2,0,0,9,5,1,1
22096,16,19,24,27,33,1,6,2022-08-22,119,17,3,0,3,2,0,0,7,5,1,0
22097,5,13,22,28,29,5,11,2022-08-24,97,24,3,1,2,2,1,0,16,6,2,1
22098,1,3,6,11,13,3,11,2022-08-27,34,12,4,4,1,0,0,1,14,8,2,1
22099,7,18,25,27,33,4,5,2022-08-29,110,26,4,1,1,3,0,0,9,1,1,0
22100,10,19,20,23,31,3,7,2022-08-31,103,21,3,1,3,1,1,0,10,4,2,1
22101,2,4,6,7,8,3,6,2022-09-03,27,6,1,5,0,0,2,0,9,3,1,0
22102,1,5,14,20,30,2,4,2022-09-05,70,29,2,2,2,1,0,0,6,2,0,0
22103,8,12,16,21,32,1,12,2022-09-07,89,24,1,2,2,1,0,0,13,11,1,1
22104,3,5,13,19,25,2,5,2022-09-10,65,22,5,2,2,1,0,0,7,3,1,0
22105,1,8,9,21,22,1,4,2022-09-12,61,21,3,3,2,0,2,0,5,3,1,0
22106,16,17,21,28,32,4,7,2022-09-14,114,16,2,0,3,2,1,1,11,3,1,1
22107,7,9,19,28,29,8,10,2022-09-17,92,22,4,2,1,2,1,1,18,2,0,1
22108,4,7,13,26,28,7,11,2022-09-19,78,24,2,2,1,2,0,2,18,4,2,1
22109,5,9,24,29,35,5,12,2022-09-21,102,30,4,2,1,2,0,0,17,7,1,1
22110,2,13,16,18,23,3,6,2022-09-24,72,21,2,1,4,0,0,0,9,3,1,0
22111,6,12,16,19,31,6,10,2022-09-26,84,25,2,2,2,1,0,1,16,4,0,1
22112,4,11,18,20,26,6,12,2022-09-28,79,22,1,2,2,1,0,0,18,6,0,1
22113,13,15,22,31,33,5,12,2022-10-05,114,20,4,0,3,2,0,0,17,7,1,1
22114,11,21,24,27,28,5,10,2022-10-08,111,17,3,1,2,2,1,0,15,5,1,1
22115,17,19,20,23,27,3,8,2022-10-10,106,10,4,0,4,1,1,1,11,5,1,1
22116,1,7,20,22,31,7,12,2022-10-12,81,30,3,2,2,1,0,1,19,5,1,1
22117,9,12,15,21,32,2,7,2022-10-15,89,23,3,2,2,1,0,0,9,5,1,1
22118,2,5,15,17,26,2,8,2022-10-17,65,24,3,2,2,1,0,1,10,6,0,1
22119,1,9,16,25,29,4,9,2022-10-19,80,28,4,2,1,2,0,0,13,5,1,1
22120,11,22,26,30,33,3,5,2022-10-22,122,22,2,1,1,3,0,0,8,2,2,0
22121,4,15,16,20,21,4,5,2022-10-24,76,17,2,1,4,0,2,0,9,1,1,0
22122,4,15,17,19,25,6,12,2022-10-26,80,21,4,1,3,1,0,2,18,6,0,1
22123,2,20,28,29,30,7,10,2022-10-29,109,28,1,1,1,3,2,0,17,3,1,1
22124,2,4,11,25,30,6,12,2022-10-31,72,28,2,3,0,2,0,2,18,6,0,1
22125,3,7,14,16,19,1,11,2022-11-02,59,16,3,2,3,0,0,0,12,10,2,1
22126,4,5,8,22,35,1,3,2022-11-05,74,31,2,3,1,1,1,0,4,2,2,0
22127,2,3,8,9,20,4,10,2022-11-07,42,18,2,4,1,0,2,1,14,6,0,1
22128,10,19,21,23,35,4,10,2022-11-09,108,25,4,1,3,1,0,0,14,6,0,1
22129,10,17,23,34,35,1,4,2022-11-12,119,25,3,1,2,2,1,3,5,3,1,0
22130,5,7,15,18,23,5,10,2022-11-14,68,18,4,2,3,0,0,1,15,5,1,1
22131,2,6,8,10,17,5,6,2022-11-16,43,15,1,4,1,0,0,0,11,1,1,0
22132,2,27,30,34,35,9,12,2022-11-19,128,33,2,1,0,4,1,1,21,3,1,1
22133,1,2,14,30,31,6,9,2022-11-21,78,30,2,2,1,2,2,2,15,3,1,1
22134,3,16,23,27,32,3,6,2022-11-23,101,29,3,1,2,2,0,0,9,3,1,0
22135,9,10,27,31,32,1,3,2022-11-26,109,23,3,2,0,3,2,2,4,2,2,0
22136,1,11,15,17,33,3,11,2022-11-28,77,32,5,2,2,1,0,0,14,8,2,1
22137,5,6,8,15,20,7,8,2022-11-30,54,15,2,3,2,0,1,1,15,1,1,1
22138,5,13,16,27,33,7,12,2022-12-03,94,28,4,1,2,2,0,1,19,5,1,1
22139,1,13,14,22,35,2,5,2022-12-05,85,34,3,1,3,1,1,1,7,3,1,0
22140,5,15,25,26,29,4,12,2022-12-07,100,24,4,1,1,3,1,0,16,8,0,1
22141,5,6,14,24,25,2,4,2022-12-10,74,20,2,2,2,1,2,2,6,2,0,0
22142,7,12,14,29,35,1,11,2022-12-12,97,28,3,2,1,2,0,1,12,10,2,1
22143,10,13,14,27,33,7,8,2022-12-14,97,23,3,1,2,2,1,1,15,1,1,1
22144,3,4,8,15,21,4,7,2022-12-17,51,18,3,3,2,0,1,0,11,3,1,1
22145,10,20,29,30,35,6,9,2022-12-19,124,25,2,1,1,3,1,0,15,3,1,1
22146,1,21,23,28,35,7,9,2022-12-21,108,34,4,1,2,2,0,1,16,2,2,1
22147,4,12,22,28,30,9,11,2022-12-24,96,26,0,2,1,2,0,1,20,2,2,1
22148,4,5,6,26,27,7,12,2022-12-26,68,23,2,3,0,2,3,1,19,5,1,1
22149,15,19,22,26,28,2,7,2022-12-28,110,13,2,0,3,2,0,1,9,5,1,1
22150,6,7,26,29,30,3,12,2022-12-31,98,24,2,2,0,3,2,1,15,9,1,1
23001,18,19,24,27,34,11,12,2023-01-02,122,16,2,0,3,2,1,0,23,1,1,1
23002,11,14,21,26,27,2,7,2023-01-04,99,16,3,1,2,2,1,1,9,5,1,1
23003,5,6,14,21,22,2,9,2023-01-07,68,17,2,2,3,0,2,2,11,7,1,1
23004,4,13,15,20,22,4,8,2023-01-09,74,18,2,1,4,0,0,1,12,4,0,1
23005,1,3,10,20,29,6,11,2023-01-11,63,28,3,3,1,1,0,1,17,5,1,1
23006,2,4,12,27,35,6,7,2023-01-14,80,33,2,3,0,2,0,0,13,1,1,1
23007,2,3,24,30,32,1,6,2023-01-16,91,30,1,2,1,2,1,1,7,5,1,0
23008,4,9,17,22,25,1,5,2023-01-18,77,21,3,2,2,1,0,0,6,4,2,0
23009,1,5,11,15,33,1,10,2023-01-30,65,32,5,3,1,1,0,0,11,9,1,1
23010,5,6,13,23,26,1,6,2023-02-01,73,21,3,2,2,1,1,1,7,5,1,0
23011,2,7,8,17,25,1,3,2023-02-04,59,23,3,3,1,1,1,0,4,2,2,0
23012,7,16,17,18,28,2,3,2023-02-06,86,21,2,1,3,1,2,2,5,1,1,0
23013,1,2,9,23,25,2,6,2023-02-08,60,24,4,3,1,1,1,0,8,4,0,0
23014,3,8,18,22,24,1,9,2023-02-11,75,21,1,2,3,0,0,0,10,8,2,1
23015,8,16,24,25,34,8,12,2023-02-13,107,26,1,1,2,2,1,2,20,4,0,1
23016,2,4,12,31,32,7,11,2023-02-15,81,30,1,3,0,2,1,0,18,4,2,1
23017,2,5,9,22,27,10,11,2023-02-18,65,25,3,3,1,1,0,1,21,1,1,1
23018,4,8,17,26,30,3,11,2023-02-20,85,26,1,2,1,2,0,0,14,8,2,1
23019,5,8,9,11,15,6,8,2023-02-22,48,10,4,4,1,0,1,1,14,2,0,1
23020,5,6,23,25,28,6,9,2023-02-25,87,23,3,2,1,2,1,1,15,3,1,1
23021,2,9,18,23,27,3,5,2023-02-27,79,25,3,2,2,1,0,1,8,2,2,0
23022,7,11,15,26,28,8,10,2023-03-01,87,21,3,2,1,2,0,0,18,2,0,1
23023,9,21,23,25,33,3,10,2023-03-04,111,24,5,1,2,2,0,0,13,7,1,1
23024,11,15,24,27,30,1,10,2023-03-06,107,19,3,1,2,2,0,0,11,9,1,1
23025,3,9,27,30,31,11,12,2023-03-08,100,28,4,2,0,3,1,2,23,1,1,1
23026,2,13,24,27,30,1,6,2023-03-11,96,28,2,1,2,2,0,2,7,5,1,0
23027,9,10,12,15,23,3,6,2023-03-13,69,14,3,3,2,0,1,0,9,3,1,0
23028,1,3,29,30,34,4,12,2023-03-15,97,33,3,2,0,3,1,0,16,8,0,1
23029,7,25,27,34,35,9,11,2023-03-18,128,28,4,1,0,4,1,1,20,2,2,1
23030,6,11,12,20,35,5,12,2023-03-20,84,29,2,3,1,1,1,1,17,7,1,1
23031,5,7,8,16,25,3,11,2023-03-22,61,20,3,3,1,1,1,0,14,8,2,1
23032,5,6,18,28,30,2,7,2023-03-25,87,25,1,2,1,2,1,1,9,5,1,1
23033,4,6,10,11,25,7,9,2023-03-27,56,21,2,4,0,1,1,1,16,2,2,1
23034,7,9,10,15,24,4,12,2023-03-29,65,17,3,3,2,0,1,1,16,8,0,1
23035,7,14,23,25,29,2,11,2023-04-01,98,22,4,1,2,2,0,1,13,9,1,1
23036,1,13,22,26,31,2,10,2023-04-03,93,30,3,1,2,2,0,0,12,8,0,1
23037,6,8,16,20,24,7,8,2023-04-05,74,18,0,2,3,0,0,0,15,1,1,1
23038,4,10,18,27,32,10,12,2023-04-08,91,28,1,2,1,2,0,0,22,2,0,1
23039,2,24,26,30,34,6,7,2023-04-10,116,32,0,1,1,3,0,0,13,1,1,1
23040,4,5,18,22,30,5,12,2023-04-12,79,26,1,2,2,1,1,1,17,7,1,1
23041,5,8,13,26,35,5,9,2023-04-15,87,30,3,2,1,2,0,1,14,4,2,1
23042,2,16,21,23,27,1,8,2023-04-17,89,25,3,1,3,1,0,0,9,7,1,1
23043,2,4,17,20,27,1,8,2023-04-19,70,25,2,2,2,1,0,2,9,7,1,1
23044,2,6,7,8,15,7,10,2023-04-22,38,13,2,4,1,0,2,1,17,3,1,1
23045,7,10,13,28,31,4,5,2023-04-24,89,24,3,2,1,2,0,1,9,1,1,0
23046,13,21,25,28,32,2,10,2023-04-26,119,19,3,0,2,3,0,2,12,8,0,1
23047,10,12,13,24,25,11,12,2023-04-29,84,15,2,2,2,1,2,2,23,1,1,1
23048,7,13,16,25,32,9,11,2023-05-01,93,25,3,1,2,2,0,2,20,2,2,1
23049,3,17,22,26,28,7,12,2023-05-03,96,25,2,1,2,2,0,0,19,5,1,1
23050,8,9,14,25,29,4,6,2023-05-06,85,21,3,2,1,2,1,0,10,2,0,0
23051,3,11,19,29,33,3,12,2023-05-08,95,30,5,2,1,2,0,1,15,9,1,1
23052,2,8,11,30,33,5,8,2023-05-10,84,31,2,3,0,2,0,2,13,3,1,1
23053,1,3,11,14,20,2,11,2023-05-13,49,19,3,3,2,0,0,1,13,9,1,1
23054,19,25,30,31,34,7,9,2023-05-15,139,15,3,0,1,4,1,0,16,2,2,1
23055,6,8,12,13,15,1,6,2023-05-17,54,9,2,3,2,0,1,0,7,5,1,0
23056,13,22,24,33,34,1,2,2023-05-20,126,21,2,0,3,2,1,1,3,1,1,0
23057,1,5,6,19,24,5,11,2023-05-22,55,23,3,3,2,0,1,1,16,6,2,1
23058,19,22,29,32,35,5,8,2023-05-24,137,16,3,0,2,3,0,1,13,3,1,1
23059,9,13,23,25,28,4,7,2023-05-27,98,19,4,1,2,2,0,0,11,3,1,1
23060,2,7,19,24,30,9,12,2023-05-29,82,28,2,2,2,1,0,0,21,3,1,1
23061,7,11,21,30,32,5,7,2023-05-31,101,25,3,2,1,2,0,2,12,2,2,1
23062,6,8,22,24,30,1,8,2023-06-03,90,24,0,2,2,1,0,1,9,7,1,1
23063,4,18,29,31,34,6,9,2023-06-05,116,30,2,1,1,3,0,0,15,3,1,1
23064,2,6,9,31,32,3,7,2023-06-07,80,30,2,3,0,2,1,1,10,4,2,1
23065,8,14,16,21,25,3,12,2023-06-10,84,17,2,1,3,1,0,0,15,9,1,1
23066,6,11,13,30,32,1,3,2023-06-12,92,26,2,2,1,2,0,0,4,2,2,0
23067,2,28,30,33,35,2,10,2023-06-14,128,33,2,1,0,4,0,1,12,8,0,1
23068,21,22,24,27,31,7,8,2023-06-17,125,10,3,0,3,2,1,0,15,1,1,1
23069,8,20,21,25,32,5,7,2023-06-19,106,24,2,1,2,2,1,1,12,2,2,1
23070,10,26,29,32,33,3,11,2023-06-21,130,23,2,1,0,4,1,1,14,8,2,1
23071,2,11,12,32,34,10,12,2023-06-24,91,32,1,3,0,2,1,1,22,2,0,1
23072,5,6,9,11,14,2,4,2023-06-26,45,9,3,4,1,0,1,1,6,2,0,0
23073,15,25,28,30,35,8,10,2023-06-28,133,20,3,0,1,4,0,0,18,2,0,1
23074,3,13,22,29,34,2,9,2023-07-01,101,31,3,1,2,2,0,0,11,7,1,1
23075,7,17,20,23,32,5,11,2023-07-03,99,25,3,1,3,1,0,0,16,6,2,1
23076,8,9,11,26,34,2,7,2023-07-05,88,26,2,3,0,2,1,0,9,5,1,1
23077,5,16,18,26,35,3,6,2023-07-08,100,30,2,1,2,2,0,1,9,3,1,0
23078,2,3,6,26,27,7,8,2023-07-10,64,25,2,3,0,2,2,1,15,1,1,1
23079,6,8,26,29,34,5,8,2023-07-12,103,28,1,2,0,3,0,2,13,3,1,1
23080,1,2,9,16,30,1,11,2023-07-15,58,29,2,3,1,1,1,0,12,10,2,1
23081,5,6,23,28,35,7,10,2023-07-17,97,30,3,2,1,2,1,0,17,3,1,1
23082,2,8,9,15,20,3,9,2023-07-19,54,18,2,3,2,0,1,0,12,6,2,1
23083,13,15,21,25,32,9,10,2023-07-22,106,19,4,0,3,2,0,1,19,1,1,1
23084,3,5,8,24,32,7,8,2023-07-24,72,29,2,3,1,1,0,1,15,1,1,1
23085,11,12,26,31,35,5,7,2023-07-26,115,24,3,2,0,3,1,0,12,2,2,1
23086,3,11,15,20,35,7,11,2023-07-29,84,32,4,2,2,1,0,2,18,4,2,1
23087,3,4,16,19,24,4,5,2023-07-31,66,21,2,2,3,0,1,1,9,1,1,0
23088,8,14,16,22,24,9,12,2023-08-02,84,16,0,1,4,0,0,2,21,3,1,1
23089,3,12,20,26,35,2,12,2023-08-05,96,32,2,2,1,2,0,0,14,10,0,1
23090,8,11,12,19,35,11,12,2023-08-07,85,27,3,3,1,1,1,2,23,1,1,1
23091,6,16,18,28,29,7,11,2023-08-09,97,23,1,1,2,2,1,0,18,4,2,1
23092,3,16,21,26,32,3,12,2023-08-12,98,29,2,1,2,2,0,1,15,9,1,1
23093,11,14,17,19,21,1,5,2023-08-14,82,10,4,1,4,0,0,1,6,4,2,0
23094,12,19,22,28,32,8,12,2023-08-16,113,20,1,1,2,2,0,1,20,4,0,1
23095,8,19,28,32,34,3,7,2023-08-19,121,26,1,1,1,3,0,3,10,4,2,1
23096,6,7,14,21,31,3,10,2023-08-21,79,25,3,2,2,1,1,0,13,7,1,1
23097,6,7,18,20,22,3,9,2023-08-23,73,16,1,2,3,0,1,2,12,6,2,1
23098,2,7,15,30,34,5,9,2023-08-26,88,32,2,2,1,2,0,1,14,4,2,1
23099,9,11,13,22,23,6,7,2023-08-28,78,14,4,2,3,0,1,0,13,1,1,1
23100,4,6,13,19,35,9,11,2023-08-30,77,31,3,2,2,1,0,1,20,2,2,1
23101,6,14,16,17,28,7,10,2023-09-02,81,22,1,1,3,1,1,1,17,3,1,1
23102,2,4,7,16,33,7,11,2023-09-04,62,31,2,3,1,1,0,1,18,4,2,1
23103,8,11,19,31,32,8,11,2023-09-06,101,24,3,2,1,2,1,0,19,3,1,1
23104,6,15,16,32,33,8,10,2023-09-09,102,27,2,1,2,2,2,1,18,2,0,1
23105,7,8,19,20,25,2,11,2023-09-11,79,18,3,2,2,1,2,0,13,9,1,1
23106,16,24,26,28,31,1,6,2023-09-13,125,15,1,0,2,3,0,0,7,5,1,0
23107,1,12,15,16,18,3,10,2023-09-16,62,17,2,2,3,0,1,1,13,7,1,1
23108,5,6,17,30,32,2,8,2023-09-18,90,27,2,2,1,2,1,0,10,6,0,1
23109,1,12,21,22,31,2,9,2023-09-20,87,30,3,2,2,1,1,0,11,7,1,1
23110,4,9,11,13,17,7,8,2023-09-23,54,13,4,3,2,0,0,0,15,1,1,1
23111,3,12,15,28,35,2,12,2023-09-25,93,32,3,2,1,2,0,0,14,10,0,1
23112,1,11,17,22,27,2,9,2023-09-27,78,26,4,2,2,1,0,0,11,7,1,1
23113,6,8,30,32,33,3,10,2023-09-30,109,27,1,2,0,3,1,0,13,7,1,1
23114,2,25,27,30,35,1,10,2023-10-07,119,33,3,1,0,4,0,1,11,9,1,1
23115,7,10,23,31,34,2,10,2023-10-09,105,27,3,2,1,2,0,0,12,8,0,1
23116,1,3,9,18,29,4,9,2023-10-11,60,28,4,3,1,1,0,0,13,5,1,1
23117,5,7,15,18,20,3,4,2023-10-14,65,15,3,2,3,0,0,1,7,1,1,0
23118,6,7,13,25,33,5,8,2023-10-16,84,27,4,2,1,2,1,1,13,3,1,1
23119,4,8,10,14,21,4,10,2023-10-18,57,17,1,3,2,0,0,0,14,6,0,1
23120,2,8,16,31,34,1,10,2023-10-21,91,32,1,2,1,2,0,1,11,9,1,1
23121,5,11,15,23,33,1,9,2023-10-23,87,28,5,2,2,1,0,0,10,8,2,1
23122,1,7,9,25,29,10,12,2023-10-25,71,28,5,3,0,2,0,0,22,2,0,1
23123,2,14,16,28,30,2,7,2023-10-28,90,28,0,1,2,2,0,0,9,5,1,1
23124,6,18,23,27,32,6,10,2023-10-30,106,26,2,1,2,2,0,0,16,4,0,1
23125,7,25,26,29,32,2,8,2023-11-01,119,25,3,1,0,4,1,1,10,6,0,1
23126,7,12,17,26,34,2,6,2023-11-04,96,27,2,2,1,2,0,2,8,4,0,0
23127,4,7,8,18,19,2,6,2023-11-06,56,15,2,3,2,0,2,1,8,4,0,0
23128,1,5,7,12,13,2,6,2023-11-08,38,12,4,4,1,0,1,1,8,4,0,0
23129,9,23,25,27,33,6,12,2023-11-11,117,24,5,1,1,3,0,0,18,6,0,1
23130,13,20,27,29,30,1,7,2023-11-13,119,17,3,0,2,3,1,1,8,6,2,1
23131,3,7,21,22,24,6,7,2023-11-15,77,21,3,2,3,0,1,0,13,1,1,1
23132,3,4,12,15,23,2,6,2023-11-18,57,20,3,3,2,0,1,1,8,4,0,0
23133,10,18,25,28,33,5,11,2023-11-20,114,23,2,1,1,3,0,0,16,6,2,1
23134,10,15,22,27,33,1,12,2023-11-22,107,23,3,1,2,2,0,2,13,11,1,1
23135,5,18,22,28,29,9,12,2023-11-25,102,24,2,1,2,2,1,1,21,3,1,1
23136,13,23,27,30,34,6,9,2023-11-27,127,21,3,0,2,3,0,0,15,3,1,1
23137,4,19,21,30,31,6,12,2023-11-29,105,27,3,1,2,2,1,1,18,6,0,1
23138,7,12,20,28,31,9,10,2023-12-02,98,24,2,2,1,2,0,1,19,1,1,1
23139,15,16,25,31,34,5,9,2023-12-04,121,19,3,0,2,3,1,1,14,4,2,1
23140,1,2,9,19,30,1,2,2023-12-06,61,29,3,3,1,1,1,0,3,1,1,0
23141,4,22,25,30,31,4,5,2023-12-09,112,27,2,1,1,3,1,1,9,1,1,0
23142,4,13,15,17,32,10,12,2023-12-11,81,28,3,1,3,1,0,1,22,2,0,1
23143,9,20,23,29,33,2,10,2023-12-13,114,24,4,1,2,2,0,0,12,8,0,1
23144,5,14,18,25,35,1,10,2023-12-16,97,30,3,1,2,2,0,0,11,9,1,1
23145,6,10,12,32,33,6,7,2023-12-18,93,27,1,3,0,2,1,0,13,1,1,1
23146,14,18,19,26,31,2,7,2023-12-20,108,17,2,0,3,2,1,0,9,5,1,1
23147,6,7,19,33,34,3,8,2023-12-23,99,28,3,2,1,2,2,1,11,5,1,1
23148,11,12,20,21,27,2,12,2023-12-25,91,16,3,2,2,1,2,0,14,10,0,1
23149,1,16,17,21,29,1,6,2023-12-27,84,28,4,1,3,1,1,1,7,5,1,0
23150,5,6,17,18,33,11,12,2023-12-30,79,28,3,2,2,1,2,1,23,1,1,1
24001,3,9,17,26,35,2,7,2024-01-01,90,32,4,2,1,2,0,1,9,5,1,1
24002,1,6,8,27,32,3,4,2024-01-03,74,31,2,3,0,2,0,0,7,1,1,0
24003,7,9,12,23,29,1,2,2024-01-06,80,22,4,3,1,1,0,0,3,1,1,0
24004,2,6,18,19,27,8,9,2024-01-08,72,25,2,2,2,1,1,0,17,1,1,1
24005,3,5,7,9,12,5,8,2024-01-10,36,9,4,5,0,0,0,0,13,3,1,1
24006,8,13,16,17,33,2,10,2024-01-13,87,25,3,1,3,1,1,0,12,8,0,1
24007,4,5,28,34,35,4,11,2024-01-15,106,31,2,2,0,3,2,0,15,7,1,1
24008,4,6,11,20,30,3,5,2024-01-17,71,26,1,3,1,1,0,1,8,2,2,0
24009,15,18,19,24,26,5,9,2024-01-20,102,11,2,0,4,1,1,0,14,4,2,1
24010,2,8,10,15,27,2,8,2024-01-22,62,25,2,3,1,1,0,1,10,6,0,1
24011,1,3,27,32,34,1,7,2024-01-24,97,33,3,2,0,3,0,1,8,6,2,1
24012,21,22,25,26,34,1,9,2024-01-27,128,13,2,0,2,3,2,1,10,8,2,1
24013,5,22,25,28,30,3,12,2024-01-29,110,25,2,1,1,3,0,2,15,9,1,1
24014,4,5,16,21,31,9,11,2024-01-31,77,27,3,2,2,1,1,1,20,2,2,1
24015,8,11,14,24,31,5,6,2024-02-03,88,23,2,2,2,1,0,1,11,1,1,0
24016,15,18,25,27,29,6,11,2024-02-05,114,14,4,0,2,3,0,0,17,5,1,1
24017,3,7,25,27,35,1,4,2024-02-07,97,32,5,2,0,3,0,2,5,3,1,0
24018,4,12,19,25,27,1,9,2024-02-19,87,23,3,2,1,2,0,2,10,8,2,1
24019,19,20,26,29,30,3,4,2024-02-21,124,11,2,0,2,3,2,1,7,1,1,0
24020,2,4,8,19,26,2,6,2024-02-24,59,24,1,3,1,1,0,2,8,4,0,0
24021,1,12,16,20,28,7,9,2024-02-26,77,27,1,2,2,1,0,0,16,2,2,1
24022,7,9,11,31,32,4,8,2024-02-28,90,25,4,3,0,2,1,0,12,4,0,1
24023,8,10,12,14,22,5,9,2024-03-02,66,14,0,3,2,0,0,0,14,4,2,1
24024,3,5,12,17,26,1,12,2024-03-04,63,23,3,3,1,1,0,1,13,11,1,1
24025,1,2,8,18,27,4,8,2024-03-06,56,26,2,3,1,1,1,0,12,4,0,1
24026,1,18,21,26,33,2,12,2024-03-09,99,32,3,1,2,2,0,2,14,10,0,1
24027,8,9,16,22,23,7,9,2024-03-11,78,15,2,2,3,0,2,0,16,2,2,1
24028,13,18,20,26,28,4,8,2024-03-13,105,15,1,0,3,2,0,0,12,4,0,1
24029,4,19,24,28,34,4,5,2024-03-16,109,30,1,1,2,2,0,1,9,1,1,0
24030,8,9,11,19,30,6,12,2024-03-18,77,22,3,3,1,1,1,1,18,6,0,1
24031,9,12,15,30,34,5,6,2024-03-20,100,25,2,2,1,2,0,2,11,1,1,0
24032,5,15,26,33,35,1,9,2024-03-23,114,30,4,1,1,3,0,1,10,8,2,1
24033,4,8,10,11,15,7,9,2024-03-25,48,11,2,4,1,0,1,1,16,2,2,1
24034,23,26,27,29,33,5,8,2024-03-27,138,10,4,0,1,4,1,0,13,3,1,1
24035,5,13,17,29,33,5,12,2024-03-30,97,28,5,1,2,2,0,2,17,7,1,1
24036,2,5,11,32,34,6,10,2024-04-01,84,32,2,3,0,2,0,1,16,4,0,1
24037,17,19,20,29,35,7,11,2024-04-03,120,18,4,0,3,2,1,0,18,4,2,1
24038,15,22,24,25,29,1,5,2024-04-06,115,14,3,0,3,2,1,1,6,4,2,0
24039,3,10,11,20,22,6,10,2024-04-08,66,19,2,3,2,0,1,1,16,4,0,1
24040,5,12,16,29,30,3,6,2024-04-10,92,25,2,2,1,2,1,0,9,3,1,0
24041,6,8,14,16,28,3,5,2024-04-13,72,22,0,2,2,1,0,1,8,2,2,0
24042,1,8,15,23,35,5,12,2024-04-15,82,34,4,2,2,1,0,1,17,7,1,1
24043,3,4,8,14,27,5,7,2024-04-17,56,24,2,3,1,1,1,1,12,2,2,1
24044,3,13,15,17,22,6,10,2024-04-20,70,19,4,1,4,0,0,1,16,4,0,1
24045,9,10,14,31,32,3,8,2024-04-22,96,23,2,2,1,2,2,0,11,5,1,1
24046,6,12,17,29,30,7,11,2024-04-24,94,24,2,2,1,2,1,0,18,4,2,1
24047,11,19,21,26,35,10,11,2024-04-27,112,24,4,1,2,2,0,0,21,1,1,1
24048,12,18,21,26,28,8,9,2024-04-29,105,16,1,1,2,2,0,2,17,1,1,1
24049,4,6,9,10,22,1,8,2024-05-01,51,18,1,4,1,0,1,0,9,7,1,1
24050,3,4,14,18,26,7,9,2024-05-04,65,23,1,2,2,1,1,1,16,2,2,1
24051,5,21,22,23,29,1,2,2024-05-06,100,24,4,1,3,1,2,0,3,1,1,0
24052,2,3,13,22,34,4,8,2024-05-08,74,32,2,2,2,1,1,1,12,4,0,1
24053,1,7,19,20,35,3,9,2024-05-11,82,34,4,2,2,1,1,0,12,6,2,1
24054,5,6,9,11,22,1,3,2024-05-13,53,17,3,4,1,0,1,0,4,2,2,0
24055,7,17,22,30,34,5,7,2024-05-15,110,27,2,1,2,2,0,1,12,2,2,1
24056,16,17,18,27,35,6,12,2024-05-18,113,19,3,0,3,2,2,1,18,6,0,1
24057,9,25,30,33,34,3,9,2024-05-20,131,25,3,1,0,4,1,0,12,6,2,1
24058,6,10,13,20,32,1,2,2024-05-22,81,26,1,2,2,1,0,0,3,1,1,0
24059,17,18,20,25,31,3,12,2024-05-25,111,14,3,0,3,2,1,1,15,9,1,1
24060,3,21,25,28,30,1,12,2024-05-27,107,27,3,1,1,3,0,1,13,11,1,1
24061,1,12,19,31,33,5,8,2024-05-29,96,32,4,2,1,2,0,0,13,3,1,1
24062,5,14,15,16,33,3,5,2024-06-01,83,28,3,1,3,1,2,1,8,2,2,0
24063,7,12,16,33,34,1,3,2024-06-03,102,27,2,2,1,2,1,2,4,2,2,0
24064,5,12,21,32,33,8,9,2024-06-05,103,28,3,2,1,2,1,2,17,1,1,1
24065,5,10,18,26,27,3,6,2024-06-08,86,22,2,2,1,2,1,1,9,3,1,0
24066,13,19,20,24,25,6,7,2024-06-10,101,12,3,0,4,1,2,0,13,1,1,1
24067,3,11,14,20,22,6,9,2024-06-12,70,19,2,2,3,0,0,1,15,3,1,1
24068,15,20,31,32,33,5,10,2024-06-15,131,18,3,0,2,3,2,1,15,5,1,1
24069,7,9,16,20,24,3,7,2024-06-17,76,17,2,2,3,0,0,1,10,4,2,1
24070,4,20,21,32,34,2,9,2024-06-19,111,30,1,1,2,2,1,1,11,7,1,1
24071,6,10,15,34,35,2,10,2024-06-22,100,29,2,2,1,2,1,1,12,8,0,1
24072,4,17,21,23,32,1,6,2024-06-24,97,28,3,1,3,1,0,0,7,5,1,0
24073,7,9,12,21,23,5,9,2024-06-26,72,16,4,3,2,0,0,2,14,4,2,1
24074,2,10,11,21,27,9,11,2024-06-29,71,25,3,3,1,1,1,1,20,2,2,1
24075,8,17,26,28,32,1,10,2024-07-01,111,24,1,1,1,3,0,0,11,9,1,1
24076,1,6,22,27,35,7,12,2024-07-03,91,34,3,2,1,2,0,0,19,5,1,1
24077,1,3,25,26,29,6,12,2024-07-06,84,28,4,2,0,3,1,1,18,6,0,1
24078,5,7,10,14,15,4,7,2024-07-08,51,10,3,3,2,0,1,0,11,3,1,1
24079,3,8,17,18,23,6,11,2024-07-10,69,20,3,2,3,0,1,0,17,5,1,1
24080,3,5,24,27,28,9,11,2024-07-13,87,25,3,2,1,2,1,1,20,2,2,1
24081,14,15,25,27,34,1,10,2024-07-15,115,20,3,0,2,3,1,1,11,9,1,1
24082,8,21,23,24,26,4,5,2024-07-17,102,18,2,1,3,1,1,0,9,1,1,0
24083,9,11,12,13,30,7,9,2024-07-20,75,21,3,3,1,1,2,0,16,2,2,1
24084,4,11,16,17,23,5,10,2024-07-22,71,19,3,2,3,0,1,1,15,5,1,1
24085,2,9,16,29,35,1,6,2024-07-24,91,33,3,2,1,2,0,1,7,5,1,0
24086,11,12,14,22,28,7,11,2024-07-27,87,17,1,2,2,1,1,0,18,4,2,1
24087,7,10,20,28,34,5,10,2024-07-29,99,27,1,2,1,2,0,1,15,5,1,1
24088,1,2,23,28,32,3,5,2024-07-31,86,31,2,2,1,2,1,1,8,2,2,0
24089,5,6,29,30,34,7,8,2024-08-03,104,29,2,2,0,3,2,0,15,1,1,1
24090,2,3,6,28,33,7,11,2024-08-05,72,31,2,3,0,2,1,1,18,4,2,1
24091,1,8,11,17,21,1,2,2024-08-07,58,20,4,3,2,0,0,0,3,1,1,0
24092,2,4,25,26,31,1,6,2024-08-10,88,29,2,2,0,3,1,0,7,5,1,0
24093,16,24,26,28,29,8,12,2024-08-12,123,13,1,0,2,3,1,1,20,4,0,1
24094,12,13,24,29,31,2,8,2024-08-14,109,19,3,1,2,2,1,2,10,6,0,1
24095,1,7,19,26,27,3,5,2024-08-17,80,26,4,2,1,2,1,0,8,2,2,0
24096,2,3,23,27,31,1,10,2024-08-19,86,29,4,2,1,2,1,1,11,9,1,1
24097,7,11,12,14,19,2,8,2024-08-21,63,12,3,3,2,0,1,0,10,6,0,1
24098,3,10,15,19,29,9,10,2024-08-24,76,26,4,2,2,1,0,1,19,1,1,1
24099,4,10,24,31,35,5,8,2024-08-26,104,31,2,2,1,2,0,1,13,3,1,1
24100,2,12,19,22,32,5,11,2024-08-28,87,30,1,2,2,1,0,0,16,6,2,1
24101,16,19,22,27,35,6,10,2024-08-31,119,19,3,0,3,2,0,2,16,4,0,1
24102,1,5,9,14,20,5,11,2024-09-02,49,19,3,3,2,0,0,0,16,6,2,1
24103,19,21,29,32,33,6,8,2024-09-04,134,14,4,0,2,3,1,0,14,2,0,1
24104,1,4,9,13,17,6,9,2024-09-07,44,16,4,3,2,0,0,0,15,3,1,1
24105,14,20,21,28,32,9,11,2024-09-09,115,18,1,0,3,2,1,0,20,2,2,1
24106,5,11,19,22,29,2,12,2024-09-11,86,24,4,2,2,1,0,0,14,10,0,1
24107,6,14,16,18,34,3,10,2024-09-14,88,28,0,1,3,1,0,0,13,7,1,1
24108,16,17,21,31,34,3,8,2024-09-16,119,18,3,0,3,2,1,2,11,5,1,1
24109,12,23,26,27,28,3,11,2024-09-18,116,16,2,1,1,3,2,0,14,8,2,1
24110,1,7,8,18,28,4,12,2024-09-21,62,27,2,3,1,1,1,1,16,8,0,1
24111,3,9,19,27,30,7,11,2024-09-23,88,27,4,2,1,2,0,0,18,4,2,1
24112,5,15,24,31,34,3,10,2024-09-25,109,29,3,1,2,2,0,0,13,7,1,1
24113,16,18,25,26,33,4,8,2024-09-28,118,17,2,0,2,3,1,0,12,4,0,1
24114,12,27,30,34,35,5,11,2024-09-30,138,23,2,1,0,4,1,0,16,6,2,1
24115,3,4,12,19,24,8,12,2024-10-05,62,21,2,3,2,0,1,1,20,4,0,1
24116,1,3,6,16,25,1,11,2024-10-07,51,24,3,3,1,1,0,1,12,10,2,1
24117,2,10,22,26,28,2,4,2024-10-09,88,26,0,2,1,2,0,0,6,2,0,0
24118,1,3,9,16,19,5,11,2024-10-12,48,18,4,3,2,0,0,0,16,6,2,1
24119,6,12,28,30,33,2,7,2024-10-14,109,27,1,2,0,3,0,0,9,5,1,1
24120,4,12,17,23,27,2,8,2024-10-16,83,23,3,2,2,1,0,1,10,6,0,1
24121,7,15,18,24,33,4,5,2024-10-19,97,26,3,1,3,1,0,0,9,1,1,0
24122,5,6,9,15,17,3,10,2024-10-21,52,12,4,3,2,0,1,1,13,7,1,1
24123,3,9,16,30,31,8,9,2024-10-23,89,28,3,2,1,2,1,1,17,1,1,1
24124,2,3,7,10,25,1,11,2024-10-26,47,23,3,4,0,1,1,1,12,10,2,1
24125,10,14,19,24,26,1,10,2024-10-28,93,16,1,1,3,1,0,1,11,9,1,1
24126,2,10,17,28,34,7,8,2024-10-30,91,32,1,2,1,2,0,1,15,1,1,1
24127,2,3,10,16,28,7,10,2024-11-02,59,26,1,3,1,1,1,3,17,3,1,1
24128,3,7,10,29,31,1,3,2024-11-04,80,28,4,3,0,2,0,2,4,2,2,0
24129,7,19,30,31,34,5,7,2024-11-06,121,27,3,1,1,3,1,2,12,2,2,1
24130,11,21,25,31,32,4,10,2024-11-09,120,21,4,1,1,3,1,1,14,6,0,1
24131,2,3,4,21,26,2,3,2024-11-11,56,24,2,3,1,1,2,1,5,1,1,0
24132,5,6,10,16,31,6,9,2024-11-13,68,26,2,3,1,1,1,0,15,3,1,1
24133,8,10,14,22,29,4,6,2024-11-16,83,21,1,2,2,1,0,1,10,2,0,0
24134,1,4,7,13,33,5,6,2024-11-18,58,32,4,3,1,1,0,0,11,1,1,0
24135,6,8,22,24,30,3,8,2024-11-20,90,24,0,2,2,1,0,0,11,5,1,1
24136,1,17,20,29,34,7,8,2024-11-23,101,33,3,1,2,2,0,0,15,1,1,1
24137,8,15,16,17,21,2,5,2024-11-25,77,13,3,1,4,0,2,1,7,3,1,0
24138,5,17,20,28,34,4,9,2024-11-27,104,29,2,1,2,2,0,1,13,5,1,1
24139,5,12,20,23,24,5,7,2024-11-30,84,19,2,2,3,0,1,2,12,2,2,1
24140,3,6,15,23,31,1,12,2024-12-02,78,28,4,2,2,1,0,1,13,11,1,1
24141,2,6,7,16,20,2,11,2024-12-04,51,18,1,3,2,0,1,1,13,9,1,1
24142,8,21,24,33,34,3,10,2024-12-07,120,26,2,1,2,2,1,0,13,7,1,1
24143,16,20,22,24,31,4,5,2024-12-09,113,15,1,0,4,1,0,1,9,1,1,0
24144,6,7,8,21,30,1,5,2024-12-11,72,24,2,3,1,1,2,0,6,4,2,0
24145,1,6,9,22,24,1,3,2024-12-14,62,23,2,3,2,0,0,1,4,2,2,0
24146,5,20,21,22,32,3,4,2024-12-16,100,27,2,1,3,1,2,1,7,1,1,0
24147,12,18,21,22,31,1,7,2024-12-18,104,19,2,1,3,1,1,2,8,6,2,1
24148,6,9,20,32,35,8,11,2024-12-21,102,29,2,2,1,2,0,0,19,3,1,1
24149,2,5,16,18,22,7,9,2024-12-23,63,20,1,2,3,0,0,0,16,2,2,1
24150,4,11,23,25,34,5,7,2024-12-25,97,30,3,2,1,2,0,0,12,2,2,1
24151,5,12,17,19,35,10,11,2024-12-28,88,30,4,2,2,1,0,0,21,1,1,1
24152,1,2,7,8,31,2,10,2024-12-30,49,30,3,4,0,1,2,0,12,8,0,1
25001,5,8,16,17,27,4,7,2025-01-01,73,22,3,2,2,1,1,1,11,3,1,1
25002,19,21,22,28,32,6,9,2025-01-04,122,13,2,0,3,2,1,0,15,3,1,1
25003,10,25,30,32,34,4,10,2025-01-06,131,24,1,1,0,4,0,1,14,6,0,1
25004,2,5,9,13,33,1,7,2025-01-08,62,31,4,3,1,1,0,0,8,6,2,1
25005,5,6,8,31,32,9,11,2025-01-11,82,27,2,3,0,2,2,1,20,2,2,1
25006,3,4,13,19,35,3,10,2025-01-13,74,32,4,2,2,1,1,0,13,7,1,1
25007,15,22,23,25,31,1,9,2025-01-15,116,16,4,0,3,2,1,0,10,8,2,1
25008,1,5,7,13,35,5,12,2025-01-18,61,34,5,3,1,1,0,0,17,7,1,1
25009,3,19,21,30,32,6,9,2025-01-20,105,29,3,1,2,2,0,0,15,3,1,1
25010,5,21,28,30,32,7,12,2025-01-22,116,27,2,1,1,3,0,3,19,5,1,1
25011,3,6,7,11,27,2,8,2025-01-25,54,24,4,4,0,1,1,0,10,6,0,1
25012,2,18,19,21,25,2,11,2025-02-08,85,23,3,1,3,1,1,0,13,9,1,1
25013,14,16,18,20,35,2,5,2025-02-10,103,21,1,0,4,1,0,1,7,3,1,0
25014,5,19,22,29,35,2,10,2025-02-12,110,30,4,1,2,2,0,1,12,8,0,1
25015,7,10,24,31,35,1,8,2025-02-15,107,28,3,2,1,2,0,1,9,7,1,1
25016,5,7,12,20,29,8,12,2025-02-17,73,24,3,3,1,1,0,1,20,4,0,1
25017,10,12,26,28,31,3,10,2025-02-19,107,21,1,2,0,3,0,1,13,7,1,1
25018,1,7,9,20,28,1,4,2025-02-22,65,27,3,3,1,1,0,1,5,3,1,0
25019,7,8,11,18,23,3,11,2025-02-24,67,16,3,3,2,0,1,1,14,8,2,1
25020,1,9,12,22,29,5,9,2025-02-26,73,28,3,3,1,1,0,0,14,4,2,1
25021,10,18,25,30,35,3,12,2025-03-01,118,25,2,1,1,3,0,0,15,9,1,1
25022,1,11,13,27,29,4,10,2025-03-03,81,28,5,2,1,2,0,0,14,6,0,1
25023,10,20,22,24,25,9,12,2025-03-05,101,15,1,1,3,1,1,0,21,3,1,1
25024,6,12,13,16,23,5,8,2025-03-08,70,17,2,2,3,0,1,0,13,3,1,1
25025,3,6,8,10,25,3,7,2025-03-10,52,22,2,4,0,1,0,1,10,4,2,1
25026,2,3,7,17,30,1,9,2025-03-12,59,28,3,3,1,1,1,1,10,8,2,1
25027,3,6,11,13,20,1,11,2025-03-15,53,17,3,3,2,0,0,1,12,10,2,1
25028,6,8,20,25,29,3,7,2025-03-17,88,23,2,2,1,2,0,2,10,4,2,1
25029,5,9,26,31,33,3,10,2025-03-19,104,28,4,2,0,3,0,0,13,7,1,1
25030,3,9,14,24,28,6,7,2025-03-22,78,25,2,2,2,1,0,1,13,1,1,1
25031,14,18,20,25,35,1,7,2025-03-24,112,21,2,0,3,2,0,1,8,6,2,1
25032,12,22,25,27,28,1,2,2025-03-26,114,16,2,1,1,3,1,1,3,1,1,0
25033,1,2,8,10,33,10,12,2025-03-29,54,32,2,4,0,1,1,0,22,2,0,1
25034,4,15,22,28,33,6,8,2025-03-31,102,29,2,1,2,2,0,1,14,2,0,1
25035,22,25,28,29,30,4,8,2025-04-02,134,8,2,0,1,4,2,2,12,4,0,1
25036,4,7,13,27,30,2,6,2025-04-05,81,26,3,2,1,2,0,1,8,4,0,0
25037,5,20,23,27,31,4,6,2025-04-07,106,26,4,1,2,2,0,1,10,2,0,0
25038,7,8,20,26,34,8,9,2025-04-09,95,27,1,2,1,2,1,1,17,1,1,1
25039,3,7,14,15,19,6,10,2025-04-12,58,16,4,2,3,0,1,1,16,4,0,1
25040,2,8,16,31,32,4,12,2025-04-14,89,30,1,2,1,2,1,0,16,8,0,1
25041,3,4,21,22,27,5,11,2025-04-16,77,24,3,2,2,1,2,0,16,6,2,1
25042,6,8,11,18,20,5,11,2025-04-19,63,14,1,3,2,0,0,0,16,6,2,1
25043,3,16,20,21,27,9,11,2025-04-21,87,24,3,1,3,1,1,1,20,2,2,1
25044,15,17,21,22,26,2,8,2025-04-23,101,11,3,0,4,1,1,1,10,6,0,1
25045,8,11,21,23,27,3,8,2025-04-26,90,19,4,2,2,1,0,1,11,5,1,1
25046,4,10,15,20,34,4,7,2025-04-28,83,30,1,2,2,1,0,0,11,3,1,1
25047,3,10,11,12,21,2,3,2025-04-30,57,18,3,4,1,0,2,1,5,1,1,0
25048,2,6,17,23,35,6,11,2025-05-03,83,33,3,2,2,1,0,0,17,5,1,1
25049,9,20,22,29,34,3,8,2025-05-05,114,25,2,1,2,2,0,0,11,5,1,1
25050,15,18,20,21,34,4,10,2025-05-07,108,19,2,0,4,1,1,2,14,6,0,1
25051,2,4,13,29,31,5,12,2025-05-10,79,29,3,2,1,2,0,0,17,7,1,1
25052,2,4,11,29,30,2,8,2025-05-12,76,28,2,3,0,2,1,3,10,6,0,1
25053,14,23,29,30,33,6,12,2025-05-14,129,19,3,0,2,3,1,2,18,6,0,1
25054,3,12,16,21,29,1,2,2025-05-17,81,26,3,2,2,1,0,1,3,1,1,0
25055,8,10,25,29,30,1,2,2025-05-19,102,22,2,2,0,3,1,1,3,1,1,0
25056,12,15,28,29,32,8,11,2025-05-21,116,20,2,1,1,3,1,1,19,3,1,1
25057,9,10,11,12,29,1,10,2025-05-24,71,20,3,4,0,1,3,2,11,9,1,1
25058,6,11,15,21,23,1,7,2025-05-26,76,17,4,2,3,0,0,1,8,6,2,1
25059,3,9,10,11,26,1,2,2025-05-28,59,23,3,4,0,1,2,1,3,1,1,0
25060,12,14,19,33,34,1,7,2025-05-31,112,22,2,1,2,2,1,0,8,6,2,1
25061,2,11,16,23,28,5,10,2025-06-02,80,26,2,2,2,1,0,0,15,5,1,1
25062,14,20,27,28,29,6,10,2025-06-04,118,15,2,0,2,3,2,1,16,4,0,1
25063,5,18,26,29,32,7,10,2025-06-07,110,27,2,1,1,3,0,1,17,3,1,1
25064,5,10,18,20,34,1,8,2025-06-09,87,29,1,2,2,1,0,2,9,7,1,1
25065,7,25,32,33,35,4,9,2025-06-11,132,28,4,1,0,4,1,0,13,5,1,1
